的	dwkd
一	fi
了	ke
是	jfpz
不	gu
我	gfkg
在	euht
人	re
有	ewyz
这	toce
他	eoer
来	fqmi
个	ruse
你	exiv
说	dqlw
上	jv
到	dmdz
就	aifo
着	qjmy
大	od
们	etmr
道	qqoc
那	yapf
么	gnap
也	oe
地	hoet
子	kz
下	jx
出	wwkc
时	jhcr
看	fjms
要	pcnx
她	coen
中	lusv
没	ness
然	whib
里	vl
为	kskd
过	hocc
自	qi
好	ckzn
得	cjfh
去	hnat
可	alvd
会	rina
天	fodi
还	gocu
心	ri
后	dflv
以	ekre
小	iv
都	hjpf
和	mlvh
对	bhco
想	ajri
能	nwnn
起	hoiz
之	oz
手	fs
而	sr
只	lkav
生	ps
什	egir
身	qs
头	iodr
样	aqyu
事	hlbj
多	xxxx
己	oi
家	itsb
面	sm
知	jlvi
开	fsoi
如	clvn
无	ffoi
现	jcjw
很	cggc
点	ulib
前	qwmd
发	wbkd
经	kbpg
情	rhwy
把	fobs
老	hnbt
些	pnir
话	dlsy
已	ov
又	bo
声	hbss
意	kjri
于	fhci
回	wlvw
笑	gmyz
所	ddjh
但	ejfi
眼	jggm
成	kyiw
方	tf
年	gakz
见	cj
当	ibjv
女	cn
真	gjka
两	fcrr
力	sl
气	gq
从	rree
用	sy
长	nc
动	insl
间	tjrm
国	wjkd
走	hz
让	djvy
被	xbpy
给	krhj
正	fpii
问	tlvm
打	fads
明	jwyr
儿	wr
法	nhna
才	hgpc
几	ej
行	cicc
三	la
定	ifpz
此	pnbi
进	ikoc
再	jckw
种	mlus
将	qxhc
实	iiod
同	cflv
最	jlbo
本	afiu
向	dx
分	kmda
十	gi
学	nxkz
高	ag
第	gbug
感	kflr
怎	guri
神	jdss
听	ldjv
边	socl
作	egub
其	uq
吧	lobv
却	hnaj
口	lv
觉	nxcj
啊	lpal
因	wodw
白	db
次	ixqr
军	xxjm
做	ejtp
外	xubx
门	tm
光	ilwv
风	esij
主	kjwd
住	ekjw
果	jaur
与	hfik
全	rjwe
二	ir
候	eubj
公	knaa
相	ajmu
吗	lbmv
等	ghhc
别	lsmd
色	xobm
死	fxnb
张	bncg
部	klpf
太	okdd
日	jr
少	igpv
战	ulkg
理	jvlw
直	gjqi
重	mvlq
王	jw
像	exlt
脸	wrfn
比	nnbb
快	rbre
何	ealv
水	ns
名	xlvx
体	eafi
呢	lbnb
东	xivi
叫	lwjv
西	px
应	mnsg
便	efjs
放	ttpf
马	bm
难	beho
轻	xbpg
更	fjsi
美	qody
位	eklr
关	qodk
机	aeju
接	fkcn
先	pwrn
文	te
处	tubp
并	qsok
望	twjw
常	iujs
完	iflw
四	wwrw
飞	yiri
师	qfuj
者	hjrt
安	icnb
清	nhwy
刚	csmd
跟	pggz
月	wy
信	ebyr
山	us
爱	uxeb
内	crek
龙	fgpo
空	ipgx
带	sxuj
找	fkgs
原	vdiv
入	bu
李	akzu
连	xocj
吃	lgyi
场	hycp
平	nqkg
思	vrit
林	aauu
变	tboy
使	efls
由	do
受	uxbo
亲	kaul
命	rajh
目	jm
强	blqc
男	vslt
任	emrr
该	dthy
路	ptlv
车	xj
今	rkyi
海	ngem
加	slvl
远	floc
活	nlss
特	phhc
解	xsmp
电	dd
世	si
性	rpsx
表	hgys
许	dggi
它	inbb
立	kl
黑	gh
金	tj
红	kpgj
花	senb
转	xiek
总	qlri
算	gjso
城	hkyi
队	pref
孩	kthz
反	dboj
工	pg
始	cnlv
满	nsfr
新	kadj
兵	dfka
物	pwcp
离	twcn
非	uf
虽	lqcv
云	inar
似	eekr
万	fwbi
至	dz
干	ng
通	bsoc
认	drey
失	gofp
火	ih
哥	alal
士	hs
五	fbwi
惊	raiv
魔	mdga
竟	kjwr
姐	cjqn
乎	gqhc
剑	rfnm
往	ckjw
量	jfvl
早	jz
结	khlv
怕	rdbx
流	nanw
突	ihqx
坐	rrht
斯	udjq
音	kjrl
紧	ubos
指	fnjr
拉	fkls
杀	saui
半	qakk
记	doiy
且	jq
利	mmdh
合	rh
倒	edmd
书	yyuk
度	msfb
微	cfej
步	pivi
教	hktp
喜	hlvz
越	hkei
影	jaic
谁	dehy
冷	irkb
深	nxka
告	plvn
落	sntl
象	xlts
容	irlv
怪	rbht
传	eiek
钱	ofkg
提	fjfp
言	by
随	pewo
每	gemz
双	bboo
服	wabo
击	awkk
武	fkpi
哪	lyap
数	qctp
站	kulv
奇	oalv
房	htfh
管	gibb
灵	bihj
刻	tmdh
题	jfpc
衣	agyt
周	whlv
静	hwxy
伤	egsl
百	vjrs
拿	rfsh
妈	cbmn
办	skal
星	jpsr
化	enbr
功	pslg
绝	kxob
系	gosp
般	ueso
必	rgpi
业	ie
尔	xivm
件	epnr
血	gump
代	ekir
精	qhwy
弟	qbug
终	ktir
近	docj
条	taup
青	hwys
界	vrka
司	yflv
整	altp
欢	bxqo
字	ikzb
晚	jxlw
民	oxis
帮	dpuj
切	xmdi
即	bnaj
忙	rtwx
交	aksi
或	klfi
暗	jkjr
夫	of
员	lcbv
根	aggu
石	vs
哈	lrhv
夜	aexk
父	ksia
制	pcmd
友	eboz
阿	palv
息	qrii
冲	ilus
酒	npys
保	elau
片	dp
形	fscp
阵	pxjf
南	gcqg
决	ibre
请	dhwy
各	tlvp
报	fabo
兴	nkas
阳	pjrf
急	xbri
语	dfbl
令	rkbo
错	osjr
及	gkdn
刘	tmde
极	agkd
识	dlka
备	tvtp
慢	rjub
雪	cbjy
苦	sjgo
若	selv
领	rkbc
收	wtpj
底	mkxk
尽	bkir
准	iehr
华	engi
答	grhz
众	rrre
千	mq
消	niwy
视	jcjs
罗	uxxw
敢	yltp
留	kvtm
克	jwrg
乐	kivm
够	wlxx
跑	pwos
显	jier
嘴	lpns
官	ibbo
断	qedj
未	fw
势	frks
句	wlvb
求	fnkd
计	dgiy
论	drnb
达	oocd
则	cmdb
害	idlv
八	ka
单	qjgi
久	xkdm
脚	whna
德	cgur
元	flwi
脑	wtwk
楚	aayp
雨	cy
睛	jhwy
响	ldxv
刀	md
确	vxsy
玉	jkdw
沉	nxej
北	qnbq
格	atlv
停	eaad
陈	pxiv
市	aujt
朝	gjwy
喝	ljwe
族	tgji
江	npgs
团	whgp
母	em
章	kjzl
装	qhag
亮	aejg
客	itlv
照	jmli
乱	leis
易	jwcp
足	pz
依	eagy
黄	sdka
修	eutc
破	vbps
台	nlva
球	jfnk
呀	lhyv
院	pifl
送	qooc
包	wosb
义	ksid
诉	ddkd
攻	ptpg
丝	kkjj
围	wayi
玩	jflw
待	chhc
复	gjtp
况	ilwr
楼	aqcn
丽	fcck
痛	mbsy
梦	aaxx
呼	lgqh
摇	fujf
期	uwyq
英	scod
低	ekxk
帝	aqxu
兄	lwrv
背	qnwy
持	fhhc
爷	ksaj
皇	djwb
七	xi
六	akat
穿	ihyx
杨	aycp
政	fptp
运	inoc
居	bjgs
叶	lgiv
热	frki
校	aaks
谢	dqhc
曾	qjqj
古	jg
细	kvtj
产	kgpl
睡	jmso
希	seuj
速	aloc
室	idzb
旁	aqxt
另	lslv
怀	rgux
露	cptl
异	osos
写	xhfi
鬼	dg
娘	ckgg
取	lboe
式	kpgi
除	prfa
级	kgkd
考	hhkt
建	bagy
愿	vdir
招	fmlv
饭	xdbo
布	eujz
续	kgyo
程	mljw
首	qqik
观	bcjo
朋	wwyy
务	tslp
掉	fujz
赶	hngz
忽	wcri
注	nkjw
术	akdu
甚	ueiq
差	qpgy
呵	lalv
展	bshf
争	xbyi
品	lllv
兰	qirk
宝	ijkd
香	mjrh
斗	igir
故	jtpg
雷	cvty
念	rkyr
段	eles
顿	xwvc
角	xsym
疑	njbp
护	fhhs
闪	trem
木	au
需	csry
调	dwhl
类	qodm
妹	cfwn
爸	ksob
线	kfkg
左	epgz
游	ntgk
派	ndgy
谈	diih
激	ndtt
冰	insr
敌	ltps
跳	pwii
支	gboi
约	kwkd
巴	ob
您	exir
顾	vavc
肯	pwyi
醒	pjps
铁	ogof
抱	fwos
淡	niih
造	ploc
伙	eihr
资	ixcb
群	bglq
集	eauh
联	lqod
商	aqcl
号	lhkv
节	sajo
讲	dika
掌	ifss
赵	hsiz
密	irgu
九	rj
病	mfcr
卫	afij
米	qm
威	kfcn
继	kqei
渐	nxdj
统	kanw
追	docd
亚	lqkj
简	gtjr
练	kxyk
基	uhtq
选	pwoc
推	fehs
改	otpi
退	gocg
味	lfwv
份	ekmd
举	nkak
示	js
忍	mkri
历	vslh
器	llhl
恐	pekr
引	busg
试	dkpg
皮	bp
习	vx
靠	pluf
导	ohcs
存	eukz
莫	sjod
志	hris
区	hsif
汉	nbos
右	elvz
严	lqgp
态	okri
买	yiod
幸	hqgi
社	jhts
佛	ebka
议	dksi
树	abhc
止	pi
块	hbre
守	ihcb
毛	mm
挥	fxxj
胡	jwyg
散	swtp
板	adbo
仅	ebor
隐	pxbr
怒	cbri
床	maug
苏	sska
料	qigi
股	wesy
局	bylv
班	jqjw
图	wtir
岁	uxxs
礼	jeis
独	hqcq
初	xmdy
福	jflv
顺	lvcb
狂	hjwq
默	ghqh
巨	hbof
既	bnhw
松	akna
证	dfpi
烈	fxmi
否	glvu
恶	lqri
治	nnlv
缓	kunb
排	fufs
费	bkcb
拍	fdbs
耳	le
医	hjif
寒	iski
哭	llhq
温	njum
府	mehc
担	fjfi
称	mxiv
余	rfau
钟	olus
泪	njms
烟	iwod
仍	egnr
具	jkaq
忘	triw
恩	wori
毕	nngi
警	swlb
蓝	sugu
宫	illv
吸	lgkd
陆	pawk
究	irjx
抓	fuzs
压	vhkd
沙	nigp
救	fnkt
呆	lauv
河	nalv
迷	qocm
枪	araj
组	kjqj
权	abou
叹	lbov
孙	kivz
卷	qoaj
查	ajfi
毫	ammg
春	ojrp
察	iwjs
圣	bhto
草	sjzo
较	xaks
胜	wpsy
遇	vocy
充	anwr
史	lsiv
堂	ihts
防	ptff
据	fbjg
猛	hkum
骑	boal
土	ht
卡	jubv
助	jslq
京	aivg
银	oggj
贵	ljcb
永	knsd
质	dgcb
屋	bdzs
须	cvcb
副	flvm
换	fxco
刺	acmd
属	bgqc
闻	tlem
境	hkjw
禁	aajs
阴	pwyf
共	skao
负	xcbm
弄	jsow
翻	gqvv
虎	uh
层	bina
喊	lkfl
逃	wiio
晓	jxgl
座	mrrh
雅	hehy
参	nocp
射	qhcs
婚	ckxj
险	prfn
君	bglv
划	kmdg
坚	ubht
价	erka
柔	kgau
超	hmlv
扬	fycp
科	migi
按	ficn
狠	hggq
野	vkyl
秦	omhp
秘	mrgp
熟	akri
置	ugjq
仙	eusr
模	asjo
伸	edsr
波	nbps
肉	crre
假	ebib
齐	tkae
舞	gsfa
脱	wqlw
广	mg
姑	cjgn
麻	ma
投	fess
顶	avcb
致	dtpz
责	hcbs
景	jaiv
营	sxll
维	kehj
设	desy
坏	hgut
啦	lfkl
秀	mgnh
败	ctpb
眉	bjms
州	nlcs
药	skwk
承	ynla
案	icau
狼	hkgg
专	iekd
偷	erfm
画	fvwk
吴	lfod
店	mulv
哦	lgfk
弹	bqjg
食	ks
欲	krlx
抬	fnlv
标	ajsu
秋	mihh
厉	vfwb
良	kggd
际	pjsf
状	qhqq
烦	ivcb
午	ggiz
摆	fuhn
戏	bkgo
桌	ujau
船	uelv
短	jflq
村	ahcu
某	siau
摸	fsjo
付	ehcr
演	nifk
规	ocjf
萧	sbkk
封	hhhc
握	fbdz
田	vt
唐	mblv
藏	skdh
震	cmcy
混	njnn
虚	uieh
透	mgoc
纪	koij
凌	ihkt
休	eaur
嘛	lmav
梅	agem
紫	pnos
歌	alax
临	ugjr
毒	hems
宗	ijsb
著	shjr
索	gxos
印	kfaj
寻	bhcj
湖	njwy
劲	bpsl
职	llka
技	fgbo
恨	rggx
婆	nbcn
杰	aibu
羽	vvxx
咱	lqiv
素	hoss
凡	ekdj
值	egjq
飘	pjes
养	qoka
嘿	lghv
普	qijr
宁	iadb
吓	ljxv
兽	qvfl
夏	vjtp
读	dgyo
街	chhi
牛	pn
仿	etfr
胸	wwsw
浪	nkgg
富	iflv
尚	is
宇	ifhc
骨	rg
智	jljr
纷	kkmd
升	gsop
叔	jibo
善	qqlv
弱	bibi
架	slau
卖	gyio
袋	ekag
网	cssi
朱	pkan
骂	llbm
雄	eneh
赛	iskc
略	vtlv
杯	aguu
施	tgoe
墙	hgql
环	jguw
罪	uufw
牙	hy
窗	idtp
柳	akmu
厅	vadh
搞	fags
端	kusr
洞	ncfl
适	locs
拥	fsys
释	gqba
洋	nqys
肩	hwyh
魂	indg
闹	tauj
蒙	sxft
洗	npwr
灯	iadh
借	esjr
伯	edbr
免	xlwr
菜	suau
验	brfn
凤	eboj
鱼	xv
徐	crfa
型	fsmh
娜	cyap
暴	jskn
亡	tw
讨	dhcy
辈	uxjf
懂	rsmv
腿	wgoc
灭	fihi
妙	cigp
效	akst
危	xvaj
优	efor
盘	uumo
套	oucd
丁	ad
趣	hlbo
妖	cmyn
束	alvu
杂	rauj
诗	dhhc
迎	kaoc
舍	rlse
旧	ujrs
彩	uacp
委	mcnh
挂	fhht
笔	gmmz
狗	hwlv
鲜	xqyv
纸	kkxi
抗	faej
探	fxka
韩	gjay
尼	bnbs
控	fipg
惜	rsjr
珠	jpka
抽	fdos
创	ramd
归	qbjk
挺	fmgy
奋	ovtd
陪	pklv
硬	vfjs
避	blko
园	wflw
托	fgxi
训	dlcy
勇	bssl
聊	lkme
奶	cgnn
庄	mhtg
奔	ogso
镇	ogjk
拳	qofs
采	uauz
研	vfso
配	poiy
介	rkae
尊	qphc
冒	cijm
虑	urih
敬	swlt
丹	watb
舒	rlky
蛋	ypqc
哼	lake
宋	iaub
济	ntka
妇	cbjn
箭	gqwm
择	fbak
犯	hajq
欣	dxqj
甲	vj
欧	hsxq
课	djau
扑	fubs
菲	sufo
燕	sfli
曲	csok
躲	qeau
玄	anat
幻	nyia
茶	srau
折	fdjs
伊	ebgp
傻	edst
姓	cpsn
源	nvdi
洛	ntlv
遍	hcoc
臣	he
弃	anso
犹	hfoq
占	ulvb
漂	npjs
挑	fwii
获	shhq
绿	kbns
峰	utdf
俊	enkt
疯	mesi
列	fxmd
森	aaau
妻	gbcn
恋	triy
误	dlfo
拜	ffdf
伟	eayi
移	mxxx
纳	kcre
党	iwrs
罢	uhna
腰	wpcn
巧	phkg
孤	kugz
闭	thgp
圆	wlcb
碰	vqie
镜	okjw
软	xxqj
厚	vjkz
累	vost
昨	jgub
幽	unna
悲	urif
丈	ekdz
牌	ddgi
降	ptak
颜	kgcc
劳	sxsl
偏	ehce
省	igjm
糊	qjwy
馆	xibb
烧	ixgl
谓	dvwy
财	chgp
舰	ucjo
汗	nngs
奈	ojsd
操	flla
迹	tocy
尸	bs
悄	riwy
残	fxfk
尖	iodv
鲁	xjrv
锋	otdf
圈	wqoa
油	ndos
俩	efcr
项	pvcb
撞	fkvl
瞬	juxa
忆	ryix
盖	qumy
尤	fo
徒	chzc
乡	kgpj
概	abnw
户	hh
荡	snyc
艺	syio
增	hqjj
祖	jjqs
困	wauw
殿	bske
迅	ygoc
横	asdk
范	snaj
律	cbak
番	gqvt
企	rpie
惨	rnoc
限	pggf
聚	lbei
含	rkyl
凭	emej
剧	bjmd
碎	varg
躺	qiss
缘	kets
凉	iaiv
腾	wqob
织	klka
抢	fraj
预	kvcb
沈	nxwr
替	oojr
孔	keiz
批	fnnb
康	mbns
惑	klfr
唯	lehv
率	anig
惯	regc
登	bflq
互	femi
盯	jadm
稍	miwy
宣	ifjf
唱	ljjr
诚	dkyi
剩	mqnm
咬	laks
育	anwy
诸	dhjr
触	xsqc
晨	jmcr
策	gack
疼	mtir
漫	njub
材	ahgp
补	xuby
私	mnah
吐	lhtv
纯	kxwk
艾	ssio
贝	cb
谷	krlv
庭	mmgy
挡	fibj
晃	jilw
吉	hlvs
吹	lxqv
仔	ekzr
仇	erjr
凝	injp
鼓	hgbo
农	xgym
席	msfu
征	cfpi
帅	qujk
附	pehc
缺	jbre
塞	iskh
豪	atsg
亦	ty
杜	ahtu
努	cbsl
判	qamd
谋	dsia
胆	wjfi
尘	ihtv
扎	feis
滚	nakg
闷	trim
迟	bkoc
稳	mxbr
翼	vvvk
诺	dsel
闲	taum
灰	eihz
朵	eauj
盛	kyum
梁	nmka
晶	jjjr
餐	uxbk
爆	ijsn
伦	ernb
娇	cmka
侧	ecmd
愣	rutf
鼻	qvlj
轮	xrnb
昏	kxjr
抖	figi
陷	pxdi
敏	getp
词	dyfl
慌	rstw
愤	rgsc
怜	rrkb
颤	awlc
阶	prka
苍	sraj
距	phbo
郑	qopf
川	lc
扫	fbjs
逼	flvo
县	jnaq
忧	rfox
童	kvll
执	frkd
丢	mnar
荣	sxau
臂	blkw
逐	tocs
傲	ehwt
戴	gkvk
芒	stwo
庆	modg
伴	eqak
袭	fgag
供	eska
积	mlka
测	ncmd
遥	ujoc
阻	pjqf
例	efxm
睁	jxby
岛	musn
遗	ljco
瞪	jbfq
慕	sjok
皱	xbbp
博	gnhc
幕	sjou
猜	hhwy
益	qkum
净	ixby
泽	nbak
炼	ixyk
监	ugum
鸡	bmno
珍	jrcp
伏	ehqr
绍	kmlv
曹	sjjr
爬	uobz
丫	qusk
炸	igub
壁	blkh
涌	nbsy
凶	swki
郎	kbnp
宿	ievj
怨	xari
醉	parg
拼	fqso
迫	docb
革	sg
瞧	jeib
奥	dqod
输	xrfm
莉	smmd
忠	luri
颗	javc
嗯	lwor
佳	ehht
旅	tggy
仁	eirr
鸟	mn
骗	bhce
浩	nplv
塔	hsrh
胖	wqak
绪	khjr
枫	aesi
拔	febk
赞	pwpc
炮	iwos
傅	enhc
凯	uoej
邪	hpfy
芳	stfo
浑	nxxj
夺	ohcd
宽	iscj
堆	heht
裂	fxmg
遭	sjjo
赤	hkka
旋	tgyp
扭	fbcs
洁	nhlv
浮	nukz
悉	gqri
擦	fiwj
慧	ddbr
典	cska
赏	icbs
匆	wckd
评	dnqk
纵	krre
莲	sxoc
雾	ctsl
乌	mw
跃	pmyz
壮	qhsq
贴	culv
丰	df
隔	pflu
健	ebag
辛	kx
抵	fkxk
竹	gz
彻	cxmd
摩	mfsa
轰	xbbo
编	khce
肚	whty
插	fmdi
磨	mvsa
哎	lssi
御	cgfa
耐	shcr
惧	rjka
氏	kxim
辉	ilxx
扶	fofs
恢	reih
貌	vdwr
额	itlc
述	akoc
票	pjsx
录	bnsj
拖	fgoe
膀	waqt
鹰	meem
孟	kumz
递	qbuo
瑞	jusr
唇	mlvc
暂	xdjr
货	encb
琴	jjry
踪	pijs
码	vbms
慰	bjhr
蛇	qinb
玲	jrkb
晕	jxxj
损	flcb
轩	xngj
粗	qjqm
掩	fodd
屁	bnnb
悠	eutr
仰	ekaj
零	crkb
盟	jwum
途	rfao
贼	ckez
洪	nska
悟	rfbl
固	wjgw
讶	dhyy
冬	tirp
滑	nrgs
甜	lsir
郁	ewpf
琳	jaau
辆	xfcr
乃	gn
猪	hhjr
暖	junb
妮	cbnb
挣	fxby
旦	jfir
估	ejgr
坦	hjfi
甘	siro
佩	eefu
莱	sfqm
享	akzg
吼	lkei
构	awna
粉	qkmd
萨	spkg
吻	lwcp
潜	nooj
瓶	qsrw
偶	evyr
戒	ksog
浓	nxgy
毁	dpes
销	oiwy
迪	doco
拒	fhbo
绕	kxgl
勒	sslg
朗	kbnw
嘻	lhlv
尾	bmms
帐	uncj
废	mwbk
延	gpgy
敲	aubo
烂	iqir
曼	jubo
厌	vhqh
宜	ijqb
羞	qbcy
喂	lvhf
吟	lrky
滴	naqj
洲	nnlc
爹	ksxx
艳	dxob
晴	jhwy
抚	fffo
缩	kiej
协	gska
央	codk
悔	rgem
肖	iwyv
缠	kmvl
脆	wxva
痕	mggb
伍	efbw
寂	ijib
启	hlvh
翔	qvvx
薄	snnh
侯	ebji
劝	bslo
郭	akpf
奴	cbon
鸣	lmnv
倾	envc
彼	cbpc
扔	fgns
撒	fswt
豫	kxlt
检	arfn
针	ogij
耀	ilve
痴	mjlv
姆	cemn
篇	ghce
椅	aoal
厂	vh
董	smvl
熊	nwni
埋	hvlt
乖	mqnb
狐	hugq
蒋	sqxh
踏	pnjr
隆	ptfp
括	flss
潮	ngjw
唉	lnji
穷	islx
聪	lqlr
唤	lxco
泰	onsp
版	ddbo
末	fm
旗	tguq
仪	eksi
焦	eibh
猫	hsvt
盗	ixum
侍	ehhc
挤	ftka
款	hjxq
拾	frhs
荒	stwr
姿	ixcn
域	hklf
搭	fsrh
脉	wkns
授	fuxb
俗	ekrl
融	flcq
狱	hdhq
欺	uxqq
访	dtfy
桥	amka
锁	oicb
霸	cswy
牵	oxpn
池	noes
钻	oulv
港	nsko
喃	lgcg
廷	mgyr
乘	mqnb
玛	jbmw
奉	oakp
扯	fpis
岳	dfus
减	ikfl
弯	tbgy
夹	oqkf
辞	lkxs
岸	uvng
岂	uois
屈	bwwk
恼	rtwk
哲	fdlv
季	mkzh
召	mlvd
丧	gqhf
尝	iina
恭	skik
载	gkxj
瘦	mdub
皆	nndb
颇	bvcb
茫	sntw
染	nrau
肃	bkka
爽	osss
亏	fhki
吞	folv
惹	selr
哀	agyg
乔	mkay
趁	hrcp
铺	onfj
脏	wmht
吕	llvv
奖	qxod
倍	eklv
汤	nycp
振	fmcs
婷	caad
牢	ipnb
扰	ffos
溜	nkvt
庞	mfgp
臭	qhqi
悦	rqlw
赫	hkkk
赢	tcbw
跪	pxva
麦	htps
枝	agbo
侠	eoqk
泉	dnsb
劫	hnsl
炎	iihh
泥	nbnb
赌	chjr
弓	bg
魏	mcdg
罩	uujz
疾	mjib
饰	xguj
符	gehc
垂	msor
映	jcod
漠	nsjo
脖	wgxk
饮	xxqs
沿	nelv
懒	ralc
肤	wofy
桑	bbba
堪	huei
燃	iwhi
卓	ujzb
祝	jlwr
赖	alxc
宾	idfk
贾	pcbx
喘	lusr
焰	ixdi
吵	ligp
冥	xjak
鞋	shht
逸	xlwo
均	hwir
库	mxjg
裤	xmxj
碗	vixa
航	uaej
踢	pjwc
姨	cobg
酸	pnkt
啸	lbkk
龄	prwb
阁	ttlv
舌	ls
箱	gajm
冯	ibmr
邦	dpff
钢	ocsi
霞	cbib
促	epzr
泡	nwos
盾	dgjm
羊	qy
碧	jdvs
援	funb
忌	orii
抹	ffms
倩	ehwy
锐	oqlw
喷	lgsc
拦	fqir
嘉	hslv
袖	xdoy
殊	fxpk
辰	mc
繁	geto
络	ktlv
抛	frsl
嫁	cits
咒	llej
撤	fant
键	obag
湿	njie
恰	rrhx
虫	qc
审	idsb
献	gcqh
媚	cbjm
贤	ubcb
葛	sjwe
刹	samd
袁	hlgy
摔	fang
序	mkyg
筑	gpek
斜	rfag
瓦	rw
涂	nrfa
湾	ntbg
莎	snig
崇	uijs
猎	hsjr
刑	fsmd
墨	ghth
娃	chht
梯	aqbg
桃	awii
豆	flqk
驾	slbm
浅	nfkg
径	cbpg
饿	xgfk
疲	mbpb
搬	fues
瓜	ug
莹	sxjk
滋	nqnn
润	ntjw
铃	orkb
蛮	tqcy
蒂	saqu
拨	fwbk
涛	ndhc
予	ky
勾	wnab
惠	dric
析	adju
砍	vxqs
撑	fifs
截	gkeh
措	fsjr
币	gujp
薇	scfe
愈	rfwr
督	jibj
酷	pplv
祥	jqys
怖	reuj
侵	ebxb
岩	uvss
扮	fkmd
糟	qsjj
盈	gbum
腹	wgjt
斩	xdjj
尺	bkds
签	grfn
稀	mseu
掏	fwjf
夸	ofhk
汽	ngqs
液	naek
姬	chen
愧	rdgx
汇	nhfs
柱	akjw
粮	qkgg
堡	elah
仗	eekd
笨	gafi
奏	ofod
歉	qbux
甩	weiy
怔	rfpi
允	nwra
竞	klwr
祸	jlcr
耶	lpfe
爵	uubh
绩	khcb
诱	dmgn
呜	lmwv
穴	ix
黎	mwgn
租	mjqh
培	hklv
砸	vhuj
麽	mgna
井	ikar
窝	ilcr
弥	bxiv
返	dboc
匹	leiw
啥	lrls
凑	iofo
奸	cngn
陌	pvjr
叛	qadb
核	athu
卧	hube
幅	uflv
眨	jgoz
耗	dkmm
洒	npxs
怡	rnlv
详	dqyy
卢	ubsb
扣	flvs
哇	lhht
丑	bc
勉	xlws
孝	hkzt
矛	kgpy
氛	gkmd
衡	cxri
陶	pwjf
购	cwna
汪	njws
僵	efvf
疗	mkeb
妃	coin
罚	udmd
棋	auqu
缝	ktdo
咐	lehc
躯	qhsi
泛	ngoz
愁	miri
搜	fdub
慈	qnnr
肥	woby
笼	gfgp
篮	gugu
俱	ejka
惟	rehx
柜	ahbo
捉	fpzs
悬	jnri
霍	cehy
泄	nsis
咽	lwod
齿	prwk
秒	migp
勤	sisl
扩	fmgs
屏	bqso
霜	cajm
袍	xwos
蝶	qsau
祭	wjsy
厨	vflh
胁	wska
璃	jtwn
劈	blkm
赚	cqbk
锦	oduj
尬	frka
尴	fugu
熙	hoib
寺	hhct
昌	jjrr
贺	slcb
巾	uj
描	fsvt
捕	fnfs
陵	phkt
咳	lthv
扇	hvvx
虹	qpgc
绵	kduj
撕	fudj
蔡	swjs
催	eueh
彭	hcpz
宠	ifgp
贪	rkyc
辱	mhcc
誓	fdby
盒	rumh
寸	hc
披	fbps
饶	xxgl
搂	fqcn
跌	pgof
欠	xq
肌	wejy
售	elvh
巡	locc
抑	fkaj
纹	ktej
宏	iena
幼	nsla
萍	snnq
驻	bkjw
丛	rrfi
亿	eyir
播	fgqv
俄	egfk
刃	mkdd
蕾	scvt
挨	fnji
仲	elus
迈	fwoc
违	ayoc
辩	kdkx
埃	hnji
艘	udub
琪	juqw
灾	iihb
僧	eqjj
渡	nmsb
卑	dgig
雕	whle
鼠	dbsi
讯	dygi
辣	kalv
刷	bumd
艰	bggo
斥	dkdj
裙	xbgl
翠	vvag
饱	xwos
掠	faiv
询	dwjr
勃	gxks
夕	xx
矮	jmcn
瑶	jujf
赐	cjwc
捏	fjht
闯	tbmm
姚	cwii
瑟	jjrg
渴	njwe
谅	daiv
昂	jkaj
串	llus
沟	nwna
涉	npiv
咕	ljgv
驶	blsi
摄	flbb
贫	kmcb
辕	xhlg
婉	cixa
鹏	wwmn
姜	qcny
碍	vjfh
荷	seal
冠	xflh
魅	dfwg
玫	jtpw
裁	gkag
坡	hbpt
鸿	npmn
邓	bpfo
歪	gfpi
乏	gozp
申	ds
割	idlm
巫	prre
衫	xcpy
棒	aoak
阔	tnls
泣	nkls
韦	ayik
恍	rilw
贯	egcb
魄	ddgb
柄	afcr
患	llur
覆	pcgt
蜜	irgq
婴	cccn
励	vfws
锅	olcr
陛	pnnh
遮	msfo
帕	udbj
咖	lslv
嫌	cqbk
胳	wtlv
挖	fiyi
啪	lfdb
矿	vmgs
凄	igbc
爪	uz
眠	joxi
穆	mdic
啡	lufv
吾	fblv
坛	hina
脾	wdgi
恒	rfjf
屠	bhjr
玻	jbpw
蓉	sirl
础	vwwk
曰	jy
耸	rrle
膊	wnhc
後	cntp
逆	qwoc
寿	dhcf
驱	bhsi
猴	hebj
佣	esyr
毅	ktes
舅	dvsl
铜	ocfl
娟	clwy
眯	jqmm
淫	numr
吩	lkmd
匪	huff
牧	ptpn
役	cesc
寄	ioal
诡	dxva
纤	kmqj
腐	mehr
姻	cwod
晰	jadj
渊	nkqm
亭	aadg
邀	dtto
哄	lska
骚	bbkq
墓	sjoh
柯	aalv
筋	gwsl
崔	uehs
灿	iush
捷	ffbp
淋	naau
弗	bkag
辑	xlle
棍	ajnn
绳	kldd
频	pivc
廊	mkbp
畏	vhft
歇	jwrx
裹	ajag
苗	svto
盼	jkmd
咯	ltlv
耍	scnr
煞	xbti
寝	iqbb
瞒	jsfr
添	nfok
嫂	cdub
纠	kwjj
慨	rbnw
嚷	lasg
驰	boem
拐	flsl
宴	ijcn
津	nbak
岚	uesi
浴	nkrl
耻	lpie
挽	fxlw
页	vcbs
誉	nkby
牲	ppsn
乳	ukei
仓	raje
逝	fdoc
喉	lebj
逛	hjoc
樱	accc
兼	qbuk
戈	kg
哗	leng
涯	nvhh
捧	foak
铭	oxlv
障	pkjz
摊	fbeh
跨	pofh
妥	ucnz
揉	fkga
晋	lqjr
寞	isjo
寨	iska
漆	narn
污	nfhk
嘲	lgjw
枚	atpu
吊	lujv
乾	gjgy
馨	hbej
伪	eksk
嗓	lbba
呈	ljwv
卿	kbna
楠	agcg
籍	gdkj
裸	xjau
链	oxoc
灌	nsle
昆	jnnb
畅	dycp
逍	iwoc
帽	ucij
阅	tqlw
逗	flqo
蹲	pqph
踩	puau
窜	illu
哑	llqk
趴	pkaz
逢	tdoc
植	agjq
媒	csia
韵	kjwi
昭	jmlv
尹	bgpj
谦	dqbk
档	aibj
趟	hisz
沾	nulv
兔	xlwk
订	dady
朴	aubu
瞎	jidl
鞭	sefs
俺	eodd
斤	dj
翅	gbvv
肠	wycp
雀	iehv
慎	rgjk
盆	kmum
迁	mocq
镖	opjs
芬	skmd
崖	uvhh
丘	dfij
蠢	ojqq
庙	mdog
潘	ngqv
颖	nmvc
拓	fvss
娶	lbcn
纱	kigp
漏	nbcy
谨	dsir
珊	jwwf
仆	eubr
宙	idob
尉	bjhc
屑	biwy
叮	ladv
捂	ffbl
涩	nmkp
诧	digx
柴	pnau
杆	angu
涵	nynw
坠	prht
赔	cklv
涨	nbnc
嘟	lhjp
崩	uwwy
薛	sdkx
藤	swqn
税	mqlw
枯	ajgu
译	dbak
帘	iujx
糖	qmbl
愉	rrfm
骄	bmka
羡	qixq
糕	qqib
彬	aacp
愚	vriy
疏	ypaw
翰	gjrv
堵	hhjr
腕	wixa
眸	jnpn
芸	sina
溪	nuno
殷	dbye
谎	dstw
鼎	jddp
稿	magh
哟	lkwk
冤	xxlk
症	mfpi
棵	ajau
狄	hihq
咧	lfxm
湘	najm
宛	ixaj
嫩	calt
肆	ubak
宰	ikxb
憾	rkfr
偿	eiin
腔	wipg
哩	lvlv
豹	vwkd
瑰	jdgw
鉴	ugtj
绑	kdpf
潇	nsbk
戚	kjiv
郡	bglp
澡	nlla
桂	ahht
兮	khka
雯	ctey
颠	gjkc
狮	hqfu
邻	rkbp
契	dmod
骇	bthm
卜	ub
揭	fjwe
妄	tcnw
坑	haej
伐	ekgr
矩	jhbo
烁	ikiv
葬	sfxs
诀	dbre
鄙	lgwp
鹿	ml
柏	adbu
溃	nljc
朕	wqod
舟	uo
妆	qcnq
躁	plla
霉	cgem
侦	eucb
冻	ixiv
娅	clqk
庸	mbwy
筹	gdhc
削	iwmd
砰	vnqk
耿	lihe
牺	ppxn
筒	gcfl
遂	qtoc
旭	rjrj
胎	wnlv
惶	rdjw
淑	njib
叉	bkdo
痒	mqyb
竖	ubkl
龟	xddm
斑	jtjw
儒	ecsr
嫣	cfpi
宅	igxi
押	fvjs
胃	vwyt
旨	njrb
册	wwfi
膝	warn
浸	nbxb
弦	bana
栏	aqir
衷	augy
刮	lmds
艇	umgy
岗	ucsi
赴	hubz
囊	glxg
斧	ksdj
颊	oqvc
疆	bhff
炉	ihhh
塌	hjvv
旺	jjwr
乞	gyiz
烤	ihhk
黛	ekgh
逊	kioc
贱	cfkg
辨	kqkx
狸	hvlq
叙	rfab
愕	rllh
叠	bbbj
遣	ljbo
晌	jdxr
麟	mqxa
腥	wjps
粒	qklm
拟	fekr
俏	eiwy
杖	aekd
芝	sozo
夷	obgd
衬	xhcy
佐	eepg
巷	skos
捡	frfn
遵	qpho
塑	qwwh
桶	absy
泼	nwbk
滩	nbeh
琼	jaiv
昊	jfod
帆	uekd
搏	fnhc
颈	bpvc
噢	ldqo
蹦	puww
寡	ivjm
贞	ucbb
凰	edjw
哨	liwy
拆	fdkd
茹	sclv
劣	igsl
嘱	lbgc
沃	nmys
厢	vajm
摘	faqj
咋	lgub
坤	hdst
俯	emeh
媳	cqri
赋	cfkp
嘶	ludj
贡	pcbg
碌	vbns
匙	jfpn
拢	ffgp
谭	dpjz
翁	knvv
辜	jkxg
竭	kjwe
廉	mqbk
械	akso
贸	kcbm
辅	xnfj
讽	desi
呐	lcre
斌	tfkp
辽	koce
填	hgjk
窃	ixmd
溢	nqku
抄	figp
妒	chhn
吁	lfhc
嗦	lgxo
掀	fdxq
芙	sofo
祈	jdjs
栋	axiv
吱	lgbo
撇	fqut
胞	wwos
轿	xmka
禅	jqjg
妨	ctfn
拂	fbka
倦	eqoa
衰	afgy
靖	khwy
循	cdgj
挪	fyap
蓬	stdo
惩	cfpr
垃	hklt
账	cncb
驳	bssi
署	uhjr
甫	nf
顽	flvc
姥	chnb
圾	hgkd
熬	hwti
枕	axwr
丐	jfei
茜	spxo
咦	lobg
厕	vcmd
攀	assf
彤	wacp
妍	cfso
拽	fdgp
荆	sfsm
妓	cgbo
壶	hxie
於	trir
寇	iflb
鹤	xemn
钥	owyj
骤	blbi
渺	njig
刊	nmdg
肢	wgbo
烛	iqch
孕	gkzn
绽	kifp
彦	kgcp
棉	aduj
俘	eukz
盔	eium
剪	qwmm
诞	dgpg
兜	dkbw
凛	iawj
岭	urkb
嚣	llvl
溅	ncfk
笛	gdoz
舱	uraj
罕	xkng
鸭	vmnj
债	ehcb
噬	lgpr
钉	oadj
躬	qbgs
倚	eoal
缕	kqcn
咚	ltir
撼	fkfr
蕊	srrr
侄	edzr
佑	eelv
雁	veeh
隶	bnsj
践	pfkg
拱	fska
沐	naus
菊	swqm
蜂	qtdf
裕	xkrl
兆	wiir
搅	fnxc
尿	bnss
黯	gkjr
歹	fxxi
蓄	sanv
朦	wsxt
嘀	laqj
怯	rhna
叨	lmdv
纽	kbcj
聘	ldhk
腻	wkic
剥	bnmd
彪	ucph
沸	nbka
氓	toxi
榜	aaqt
逻	uxoc
壳	hxej
储	edhj
憋	qukr
啤	ldgi
匠	hdjf
悍	rjng
昧	jfwr
泊	ndbs
篷	gtdo
烫	nyci
狡	haks
轨	xrjj
汹	nswk
携	fegn
磊	vvvs
隙	piji
仑	rnbe
摧	fueh
瞄	jsvt
胧	wfgp
趋	hxbj
挠	fxgl
煌	idjw
擅	fawf
卒	arrg
饼	xqso
狭	hoqk
丸	rkdj
惫	tvri
瞅	jmih
犬	hq
砖	viek
矣	njia
楞	autf
昔	sjro
裳	iagy
骆	btlv
雇	hehh
阎	txdi
骷	rjgg
鸦	hmny
妞	cbcn
墅	vkht
焚	aaih
谱	dqij
绘	krin
梳	aanw
肿	wlus
魁	digi
耽	lxwr
擒	frtn
陡	phzf
璋	jkjz
茂	skwo
蹄	paqu
瞥	qukj
瞳	jkvl
髅	rqcn
绣	kmgn
硕	vvcb
肺	wfuj
兹	qnna
炒	iigp
邮	dpfo
弘	bnag
嫉	cmji
届	bdos
嗡	lknv
娱	clfo
喧	liff
脂	wnjr
膛	wiht
沧	nraj
疚	mxkd
盐	huum
扁	hceh
搁	fttl
茅	skgp
滔	nudi
坟	htet
掐	fxdi
瑜	jrfm
邱	dfpf
桐	acfl
茵	swod
苹	snqk
旷	jmgr
翘	xglv
郝	hkkp
蓦	sjob
诈	dgub
沫	nfms
菁	shwy
粹	qarg
琢	jtkd
腊	wsjr
钦	oxqj
喻	lrfm
宪	ipwr
锻	oele
睹	jhjr
郊	aksp
饥	xejs
侃	elwr
粘	qulv
媛	cunb
谊	dijq
恳	grig
厮	vudj
锤	omso
凳	bfle
淮	nehs
蔽	squt
聂	lbbo
贩	cdbo
潭	npjz
翩	hcvv
呻	ldsv
枉	ajwu
拘	fwlv
煮	hjib
焉	fphi
址	hpit
匕	nb
渗	nnoc
览	ugcj
敦	aktp
厦	vvjt
蕴	skju
冉	chtk
薪	skad
呃	lvaj
峻	unkt
荐	seuk
栽	gkau
嚎	lats
汁	ngis
傍	eaqt
秃	mejh
磕	vhnu
禀	awlj
珑	jfgp
坎	hxqt
邵	mlpf
萌	sjwy
窄	igub
阮	pflw
蹈	pudi
碑	vdgi
婶	cids
煤	isia
寓	ivyb
栈	afkg
滞	nsxu
倘	eisr
杭	aaej
暇	jbib
狈	hcbq
峡	uoqk
侣	ellv
芦	shho
蔓	sjub
蒸	syni
禄	jbns
胀	wncy
醋	psjr
淌	niss
伞	rqgi
姊	cgeg
钩	owna
衍	cnic
妾	kcnl
嘎	lvjk
蜀	uwqc
蝴	qjwy
萝	suxx
莽	shso
弩	cbbg
祷	jdhc
稚	mehh
圳	hlct
徽	cfos
衙	cfbi
咸	kflv
陋	pfce
奢	ohjr
罐	jsle
霄	ciwy
毙	nnfn
汝	ncns
敞	itps
暮	sjoj
嘘	luie
灼	iwkd
澜	ntaq
姗	cwwf
倪	edwr
挫	frrh
咪	lqmv
钧	owir
捣	fmus
燥	illa
泳	nkns
眶	jhjw
乙	yi
澈	nant
焕	ixco
酬	pnlc
筷	grbr
宵	iiwy
揪	fmih
缚	knhc
蚁	qksi
喇	lalm
丞	ynfi
拎	frkb
棠	iaus
咙	lfgp
梭	ankt
哧	lhkk
棺	aibb
璇	jtgp
瀚	ngjv
肝	wngy
敛	rfnt
剂	tkmd
疤	mobb
渔	nxvs
嗔	lgjk
沮	njqs
廖	mvvc
虏	uslh
皓	dplv
勋	lcsl
恕	clri
虐	ubjh
虞	ulfo
综	kijs
瘾	mpxr
驴	bhhm
晒	jpxr
卦	hhub
迦	sloc
陀	pinb
窥	iocj
堕	pewh
哆	lxxx
葡	swnf
帖	uulv
垫	frkh
屡	bqcn
鹅	gfkm
蛛	qpka
盲	tjmw
碟	vsau
狞	hiad
囚	wrew
诊	drcp
揽	fugc
裴	uagy
捞	fsxs
吏	flsi
铮	oxby
萄	swjf
盏	fkum
霆	cmgy
喔	lbdz
贷	ekcb
勿	wcpb
吭	laej
淘	nwjf
辟	blkx
蔑	sukk
淹	nodd
麒	muql
喽	lqcn
栗	paux
绷	kwwy
惚	rwcr
桓	afjf
坊	htft
桩	amht
嗽	lalx
履	bcgt
璐	jptl
菩	sklv
巢	ljau
畜	anvt
兀	lw
樊	asso
锡	ojwc
棚	awwy
仕	ehsr
倏	euth
芹	sdjo
僻	eblk
絮	clos
杏	alvu
浆	qxns
瘫	mbeh
啧	lhcb
磁	vqnn
冈	csik
逮	bnoc
搓	fqpg
赠	cqjj
胶	waks
脊	iirw
噩	jlll
绰	kujz
呕	lhsi
嚼	luuh
谐	dnnd
歼	fxmq
揣	fusr
殖	fxgj
拧	fiad
伺	eyfl
霖	caau
驼	binb
襄	asgy
衔	coic
惕	rjwc
掷	fqop
卸	gfpa
炽	ilka
敖	hwtp
惭	rxdj
框	ahjw
捆	fwau
眩	jana
蝉	qqjg
谜	dqoc
炫	iana
塘	hmbl
阱	pika
膜	wsjo
亨	akeg
奕	tody
蚂	qbmc
猩	hjps
滨	nidk
沁	nris
跋	pebk
藩	sngv
舔	lfok
捐	flwy
歧	pgbo
隋	pepw
蹭	pqjj
甄	phrw
蜡	qsjr
嗤	lwfq
缸	jpgf
嬉	chlv
哮	lhkz
熄	iqri
窍	iphk
俞	rfwm
豁	idll
垒	nnnh
掘	fbww
琦	joal
屎	bqms
乍	gubz
孽	sdkk
毯	miih
弧	bugg
槐	adgu
铠	ouoi
挟	foqk
襟	xaaj
梨	mmau
嗅	lqhq
祁	jpfs
纲	kcsi
渠	nhba
矢	ji
捅	fbsy
扛	fpgs
朽	ahku
忖	rhcx
匈	wswk
扒	fkas
雍	akge
莺	sxmn
侮	egem
闺	thht
霓	cdwr
稽	mfnj
斋	tsre
夭	my
沦	nrnb
揍	fofo
瞟	jpjs
苟	swlv
琉	janw
漪	nhol
暑	jhjr
窟	ibww
钓	owkd
鳞	xqxa
瓷	ixrw
萱	siff
株	apka
倭	emcn
鞘	siwy
沛	nfuj
噜	lxjr
绞	kaks
颓	mevc
睿	uxfj
噗	liqo
唔	lfbl
幢	ukvl
喀	litl
诅	djqy
涕	nqbg
拣	fxyk
谣	dujf
叽	lejv
葱	swcr
拭	fkpg
婢	cdgi
铸	odhc
绮	koal
剿	ljam
胤	wnwy
秩	mgof
畔	vqak
粥	bqbg
奎	ohht
绸	kwhl
茨	sixq
熏	mghq
蹬	pbfq
诏	dmlv
岔	kmus
叭	lkav
咆	lwos
滥	nugu
梧	afbl
垮	hofh
澳	ndqo
浙	nfdj
甸	wvtb
绯	kufj
诛	dpka
鲍	xwos
刁	yfii
厥	vqwx
蚊	qtec
鞠	swqm
歆	kjxq
拙	fwwk
茗	sxlv
眷	qojm
戮	vvrk
唬	luhv
骏	bnkt
扳	fdbo
踹	pusr
漓	ntwn
蝇	qldd
擂	fcvt
涡	nlcr
沌	nxwk
凸	ufuf
酿	pkgg
蚩	wfqc
唾	lmso
琐	jicb
犀	bnpn
澄	nbfq
哉	gklv
猾	hrgq
煎	qwmi
窒	idzx
虾	qjxc
蝠	qflv
钞	oigp
瓣	kukx
唧	lbna
觑	uicj
哽	lfjs
娥	cgfk
婿	cypw
讪	dusy
耕	dkik
葫	sjwy
暧	juxb
浇	nxgl
嗨	lnge
诵	dbsy
疫	mesb
兢	jwjw
箫	gbkk
颅	ubvc
啼	laqu
绅	kdsj
杉	acpu
嗜	lhnj
券	qomd
遁	dgjo
炯	iclv
霎	ckcn
讥	dejy
迭	gooc
彷	ctfc
觅	ucjz
娴	ctau
抿	foxi
剔	jwcm
稻	mudi
敷	nttp
泻	nxhf
怠	nlri
龚	fgsk
绒	kkez
讳	dayi
勺	wkdb
函	ynwk
喳	lajf
颂	knvc
搀	fxli
撩	foqi
擎	swlf
巍	umcd
脯	wnfy
镶	oasg
寥	ivvc
漾	nqkn
缴	kdtt
藉	sdkj
弊	quks
逞	ljoc
膏	awyg
戳	vvek
呛	lraj
凹	cfik
叩	lajv
禽	rtwn
懊	rdqo
懈	rxsp
蛟	qaks
亢	aejt
呸	lgfi
芊	smqo
慑	rlbb
跺	peau
跄	praj
蚀	xqcs
栖	apxu
蔚	sbjh
铲	okgp
坪	hnqk
筝	gxby
顷	nvcb
腮	wvri
踉	pkgg
狰	hxby
踱	pmsb
嗖	ldub
苑	sxaj
秉	mbjh
猿	hhlg
堤	hjfp
佟	etir
悯	rtte
唠	lsxs
憨	yltr
肘	whcy
拇	fems
僚	eoqi
霹	cblk
婕	cfbp
禹	gqck
啃	lpwy
匀	wirb
晖	jxxj
怅	rncx
聋	fgle
拯	fynf
忿	kmri
韧	aymk
邹	xbpf
梢	aiwy
肋	wsly
窘	ibgl
嵌	usix
婪	aacn
辖	xidl
浦	nnfs
炭	ueih
曦	jqmk
簇	gtgj
螺	qvos
酱	qxpy
屯	xwki
悴	rarg
匡	hjwf
冀	qnvk
橙	abfq
倔	ebww
陕	poqk
筱	geut
叱	lnbv
髓	repo
淳	nakz
矜	kgry
詹	xvkb
菱	shkt
芷	spio
惺	rjps
浊	nqcs
囔	lglg
朔	qwwy
憔	reib
睫	jfbp
睬	juau
鸽	rmnh
臀	bskw
吨	lxwk
笙	gpsz
戟	gjkg
沼	nmlv
谍	dsau
昕	jdjr
蛊	qumc
煜	ijkl
祀	joss
罡	ufpi
伶	erkb
荫	spwy
酥	pmhy
懦	rcsr
厄	vajh
峨	ugfk
轴	xdoj
伽	eslv
雳	cvsl
卵	kkkd
捶	fmso
檐	axvb
棘	acac
嗣	lcyl
钗	obkd
袜	xfmy
妩	cffo
炕	iaej
偎	evhf
窦	igyo
蝎	qjwe
溶	nirl
幺	na
膨	whcp
峙	uhhc
缉	klle
徊	cwlv
呗	lcbv
衅	guqa
砂	vigp
舵	uinb
昼	bkjf
迸	qsoc
斟	ueig
舆	dxfk
椒	ajib
靓	hwcj
旬	wjrb
厘	vvlh
窑	ijfx
萎	smcn
涟	nxoc
疙	mgyi
芠	steo
瘩	msrh
梵	aaek
靴	senb
侥	exgl
匿	hsel
挚	frkf
镯	ouwq
兑	qlwr
尧	xglw
徘	cufc
芽	shyo
狙	hjqq
闵	ttem
辫	kkkx
瀑	njsn
嗷	lhwt
庐	mhhg
芯	srio
禾	mh
澎	nhcp
邢	fspf
绊	kqak
蜘	qjlv
憎	rqjj
靡	mufa
褚	xhjr
湛	nuei
蒲	snnf
嚓	liwj
珂	jalv
崽	uvri
贬	cgoz
惮	rqjg
婵	cqjg
嗒	lsrh
悸	rmkz
晦	jgem
涅	njht
恬	rlsx
慷	rmbn
穹	ibgx
渣	najf
屉	bsis
缭	koqi
绢	klwy
嬴	tcnw
袱	xehq
黝	gnsl
袅	magy
淇	nuqs
茄	sslv
寅	ifdk
赦	hkkt
悻	rhqg
祟	wwjs
蛙	qhht
榻	ajvv
苇	sayi
嵩	uags
茉	sfmo
唰	lbum
咏	lkns
凿	iqgw
粪	qska
噪	llla
菌	swmh
蝙	qhce
庶	msfi
邸	kxkp
晟	jkyi
禧	jhlv
攒	fpwc
虔	uteh
旱	jngr
琛	jxka
榴	akvt
漱	nalx
忑	jrix
匣	hvjf
忐	jriv
谬	dvvc
蟒	qshs
棱	ahkt
钝	oxwk
悚	ralv
廓	makp
惘	rcqt
漉	nmls
蟹	xsmq
佬	ehnb
曳	dgpd
赎	cgyo
壤	hasg
忡	rlus
倡	ejjr
冶	inlv
姝	cpka
筠	ghwi
竿	gngz
蜷	qqoa
癌	mllu
嘈	lsjj
蚕	foqc
剖	klmd
颁	kmvc
缀	kbbb
汀	nads
谕	drfm
牡	phtn
斐	utef
懵	rsuj
皙	addb
缪	kvvc
蔷	sgql
诫	dkso
恤	rgum
咄	lwwk
馒	xjub
矫	jmka
痞	mglv
橘	akgl
氧	gqyq
贿	cewy
肮	waej
瑾	jsir
璧	blkk
烙	itlv
攘	fasg
攥	fgjo
汰	nokd
溺	nbii
铅	oelv
咔	ljub
芭	sobo
戎	kezg
褐	xjwe
巩	pekd
吆	lnav
彰	kjcp
漩	ntgp
聆	lrkb
蒜	sjjs
棕	aijs
鹃	lwmn
帜	ulka
鄂	llfp
搐	fanv
蔼	sdje
怦	rnqk
穗	mdri
亩	avtt
撰	fook
绎	kbak
牟	npna
咨	ixlv
奄	oddd
梓	akxu
绚	kwjr
阀	tekg
烘	iska
炙	wihy
翎	rkbv
惋	rixa
驯	blcm
栩	avvx
逾	rfwo
墟	huie
鬟	uufg
茬	seuh
褪	xgoc
鑫	tttj
骸	rthg
峭	uiwy
缅	ksmj
灶	ihth
洽	nrhs
祯	jucb
暄	jiff
裔	agcl
韶	kjml
缎	kele
砚	vcjs
锥	oehj
辙	xant
惦	rmul
铛	oibj
枣	acir
桦	aeng
邃	iqto
橱	avfh
搔	fbkq
腑	wmeh
萤	sxqc
枢	ahsi
遏	jwro
募	sjos
憬	rjai
庵	modd
叼	lyfi
嫖	cpjs
苛	salv
锣	ouxx
蹑	plbb
拌	fqak
奠	qpod
秽	muxx
殴	hses
喋	lsau
糙	qplo
貂	vmlv
揖	flle
葵	sbfo
榆	arfm
颐	hvcb
皂	dxib
眈	jxwr
扼	fvaj
眺	jwii
孜	ktpz
簌	galx
玺	xijk
偌	esel
蹿	pilu
蓓	sekl
弛	boeg
庇	mnnb
檀	aawf
枭	maun
螂	qkbp
趾	ppiz
崭	uxdj
妲	cjfi
掂	fmul
醇	pakz
掺	fnoc
驿	bbak
槽	asjj
惬	rhoq
镰	omqk
抡	frnb
憧	rkvl
删	wwfm
鸳	xamn
酣	psir
宦	iheb
筐	ghjw
琅	jkgg
瞻	jxvb
焱	iiih
飙	hhhs
湃	nffd
俨	elqg
跷	pxgl
栅	awwf
撅	fvqx
煽	ihvv
呱	lugv
缰	kfvf
猝	harg
衮	akng
肴	sewy
殆	fxnl
谴	dljo
蔬	sypw
飒	kesi
婧	chwy
阐	tqjg
荧	sxih
侈	exxx
霏	cufy
瘟	mjum
芜	sffo
俭	erfn
崎	uoal
亥	th
俐	emmd
屿	uhfi
譬	blkb
饺	xaks
垄	fght
畴	vdhc
杠	apgu
鬓	uidk
讼	dkna
晏	jicn
弈	tsoy
鞍	sicn
瘸	mslr
钮	obcj
珏	jjkd
钰	ojkd
傀	edgr
噔	lbfq
驭	bbom
靶	sobg
萦	sxos
韬	ayud
恙	qriy
懿	hxfr
竺	girz
吝	tlve
羁	usbm
荀	swjr
癫	mgjc
嘭	lhcp
菇	scjg
恃	rhhc
儡	evvv
瘪	mqrn
踌	pdhc
呦	lnsl
榕	airl
昵	jbnb
躇	pshj
烬	ibki
啰	luxx
酌	pwkd
丙	fcre
涎	ngpg
哒	looc
冽	ifxm
砌	vxmd
鸾	tmny
烨	ieng
翟	vveh
辗	xbsh
噎	lhxq
驹	bwlv
噼	lblk
咎	tulv
亵	afrg
陨	plcb
蠕	qcsr
冕	cixw
雌	pneh
茸	sleo
瑛	jsco
剃	qbum
掰	fkmf
蹙	kjip
橡	axlt
佯	eqyr
笃	gbmz
崛	ubww
勘	uesl
稼	mits
桀	xaau
渝	nrfm
拚	fnso
汐	nxxs
锈	omgn
磅	vaqt
壕	hats
娄	qcnm
撮	fjlb
玑	jejw
祠	jyfl
娲	clcr
鹫	aifm
黏	mrnl
珀	jdbw
睽	jbfo
栓	arjw
绫	khkt
阑	tawq
邑	lobv
瑕	jbib
磋	vqpg
粟	pqmx
薯	suhj
沪	nhhs
讷	dcre
岑	urky
炜	iayi
玮	jayi
娼	cjjr
迂	fhoc
伎	egbo
鲸	xaiv
翡	uvvx
坝	hcbt
铐	ohhk
洼	nhht
蹊	puno
寐	idfw
肾	ubwy
鸯	comn
這	bocy
敝	qukt
涧	ntjr
崆	uipg
甭	gsyu
笠	gklz
扈	hlob
哝	lxgy
芮	scre
卉	gsoi
靳	sdjg
诬	dprr
札	aeiu
婊	chgy
裘	fnkg
扉	hufh
疮	mraj
巅	ugjc
坞	hmwt
膳	wqql
剌	almd
鳄	xllh
捺	fojs
悼	rujz
茧	sqco
毋	eezm
曙	juhj
馅	xxdi
簸	gubp
忒	krii
妳	cxiv
叟	dubo
拴	frjw
嬷	cmgn
稣	xmhv
痹	mvlj
垣	hfjf
蛤	qrhc
谏	dawq
羹	qiqo
沥	nvsl
蛾	qgfk
瑚	jjwy
個	ewjg
熔	iirl
惆	rwhl
雏	xbeh
饷	xdxs
拗	fnsl
燎	ioqi
熠	ivvd
薰	smgh
蕃	sgqv
捋	fuhc
籁	galc
髦	ummb
飓	esjk
簿	gnnh
迢	mloc
汩	njys
闸	tvjm
狩	hihc
鲨	nigx
蜥	qadj
惴	rusr
胯	wofh
侨	emka
劭	mlsl
烹	akib
咣	lilw
攸	eutp
锄	ojsl
硝	viwy
颔	rkyc
鸥	hsmn
滕	wqon
寰	iufg
紊	tose
蕉	seib
稠	mwhl
蟆	qsjo
垢	hdfl
楷	annd
炊	ixqh
忻	rdjx
炳	ifcr
腆	wcsk
褒	aelg
酋	qpyk
赃	cmht
拈	fulv
抒	fkys
孰	akrk
袄	xmyy
褂	xhhu
孺	kcsr
胭	wwod
赘	hwtc
嫡	caqj
礁	veib
珉	joxi
啜	lbbb
钳	osir
晾	jaiv
茎	sbpg
隧	pqto
窿	iptp
骋	bdhk
嫦	ciuj
槛	augu
掳	fusl
莞	sifl
瓢	pjug
曜	jvve
锯	objg
猖	hjjr
遐	bibo
蹋	pjvv
飕	esdb
渍	nhcb
麾	mmma
猥	hvhf
篝	gsch
殉	fxwj
枷	aslv
蜒	qgpg
皎	daks
霁	ctka
诩	dvvx
窖	iplv
咫	bklk
檬	asxt
乒	dfgp
奚	unod
淤	ntri
溯	nqww
纺	ktfj
凋	iwhl
篱	gtwn
泌	nrgp
刨	womd
樵	aeib
忏	rmqx
盎	coum
戾	hhqh
咀	ljqv
屹	ugyi
挎	fofh
羔	qiby
殃	fxco
庚	mbre
淼	nnns
淀	nifp
隘	pqku
绛	ktak
缨	kccc
焘	dhib
璨	juxq
跤	paks
锵	oqxh
摁	fwor
痊	mrjw
嫔	cidk
來	al
臻	domh
泯	noxi
糜	mqma
睦	jhkh
喵	lsvt
缥	kpjs
褥	xmhc
魇	vhdg
汶	ntes
馋	xxli
渎	ngyo
蜿	qixa
抠	fhsi
诶	dnji
墩	hakt
棣	abns
沓	njrs
喏	lsel
诲	dgem
琶	jjob
缈	kjig
缔	kaqu
酝	pina
耷	oled
弼	bvjb
柬	awqk
浏	ntmd
拷	fhhk
剁	eamd
柿	aauj
琵	jjnn
沂	ndjs
蕙	sdri
捻	frkr
帛	dujb
柠	aiad
饵	xles
撂	fvtl
娓	cbmm
乓	dfkd
轲	xalv
髯	ucht
娉	cdhk
圭	hhtt
苔	snlv
璀	jueh
肪	wtfy
吮	lnwr
瞩	jbgc
啄	ltkd
帷	uehj
箍	gfhu
蟑	qkjz
炖	ixwk
梗	afjs
捎	fiwy
瞿	jjeh
嗬	lsel
蘑	smvs
唏	lseu
鹊	sjmn
矶	vejs
羌	qeiy
骼	rtlv
筛	gqfu
鲤	xvlv
羲	qmhk
祺	juqs
馈	xljc
伫	eifi
羿	vvso
苞	swos
犁	mmpn
铎	obak
啬	gqwl
舷	uana
矗	gjgj
癖	mblk
掣	pcmf
匾	hhce
谧	drgu
瀛	ntcn
珞	jtlv
衲	xcre
毓	geaw
恺	ruoi
纬	kayi
惰	repw
嘤	lccc
诣	dnjr
谛	daqu
藻	snla
啷	lkbp
佘	rjse
黠	ghlv
饲	xyfl
虬	qeic
涤	ntau
骡	bvos
钵	oafi
邯	sipf
笋	gbgp
瑀	jgqc
醺	pmgh
芥	srka
舜	uxxa
佼	eaks
龌	prwd
簪	ghwj
痰	miih
蹂	pkga
恻	rcmd
簧	gsdk
甥	pvsl
腼	wsmy
驮	bodm
缤	kidk
潺	nbkk
獠	hoqi
筏	gekg
锭	oifp
阙	tqwx
粤	dqhk
瞌	jhnu
琏	jxoc
髻	uhlv
龊	prwp
椎	aehu
唆	lnkt
煦	jwli
嵋	ubjm
幡	ugqv
翌	vvkl
毡	mulv
碳	vuei
鸨	ngmn
闽	tqcm
躏	pste
蜓	qmgy
咻	leau
捍	fjng
睨	jdwr
鼾	qvln
桔	ahlv
娆	cxgl
抉	fbre
蜻	qhwy
玟	jtew
徨	cdjw
嗲	lksx
碾	vbsh
哐	lhjw
粼	qxal
啐	larg
谑	dubj
嚏	lgxp
甬	bsyo
鳖	qukx
榨	aigu
倜	ewhl
稷	mvkt
妤	ckyn
篡	gjon
晤	jfbl
肇	htba
咂	lhuj
帚	bxuj
瘤	mkvt
瞠	jiht
嚅	lcsr
怆	rraj
镔	oidk
撵	foox
裆	xibj
腺	wdns
骁	bxgl
坷	halv
箐	ghwy
螃	qaqt
冢	xtkd
锢	owjg
晁	jwii
濒	npic
蝗	qdjw
烽	itdf
辘	xmlj
莘	skxo
撬	fmmm
澹	nxvb
瓮	knrw
亘	fjfi
钊	omdj
篓	gqcn
缇	kjfp
泓	nbna
宸	imcb
鞑	sooc
胄	dwyo
羚	qrkb
绥	kucn
笺	gfkg
荤	sxxj
迄	gyoc
踞	pbjg
桨	qxau
慵	rmbw
噤	laaj
幌	ujil
荻	shih
跚	pwwf
袒	xjfi
浣	nifl
榄	augc
痪	mxco
荼	srfa
晗	jrkl
阉	todd
腋	waek
骰	resg
曝	jjsn
涮	nbum
踵	pmvl
炬	ihbo
涣	nxco
俟	enji
皑	duoi
瞑	jxjk
渲	niff
擞	fqct
赂	ctlv
湮	npht
麓	aaml
铿	oubh
埔	hnft
峦	tusy
噘	lvqx
涓	nlwy
掬	fwqm
怏	rcod
莓	sgem
萃	sarg
呲	lpnb
蹒	psfr
鳌	hwtx
睐	jfqm
昱	jklr
旌	tgps
摞	fvos
們	edmr
吠	lhqv
濮	neio
卞	aubt
琬	jixa
谙	dkjr
啕	lwjf
轶	xgof
搪	fmbl
陇	pfgp
纨	krkd
膺	meew
皋	dogi
霭	cdje
呓	lsyi
橄	aylt
纶	krnb
垛	heau
嗫	llbb
盅	luum
拄	fkjw
踝	pjau
臧	kdhe
淅	nadj
岌	ugkd
岱	ekus
璞	jiqo
缄	kkfl
秧	mcod
翱	dogv
卤	uwsi
逅	dflo
靥	vhsm
磐	uevs
壑	uxfh
斓	ttaq
翊	kvvx
挛	tfsy
琰	jiih
叁	nola
佗	einb
阖	thnu
戬	lqjk
怂	rrri
汲	ngkd
垠	hggt
迥	cloc
邂	xsmo
咛	liad
杞	aoiu
痘	mflq
臊	wlla
藕	sdkv
湄	nbjm
媲	cdsn
癞	malc
辄	xlei
獒	hwth
恪	rtlv
砾	vkiv
吒	lgxi
痉	mbpg
蜕	qqlw
椰	alpf
仨	elar
纣	khcj
馁	xucn
蜈	qlfo
镐	oagj
窈	insl
說	bklw
秤	mnqk
桢	aucb
粱	nmkq
辐	xflv
悖	rgxk
涔	nury
偕	ennd
渭	nvwy
汴	naub
蜴	qjwc
桅	axva
隅	pvyf
卯	km
骜	hwtb
孚	ukzz
禺	vy
琥	juhw
阚	tylt
杵	aggi
掖	faek
畸	voal
晔	jeng
婀	cpal
菡	synw
噶	lsje
昙	jina
坍	hwat
俑	ebsy
滤	nuri
侏	epka
潦	noqi
挲	nigf
覃	pjzx
硫	vanw
俸	eoak
蟠	qgqv
弋	ki
驸	behc
梆	adpf
馀	xrfa
笈	ggkd
忱	rxwr
恿	bsri
胥	ypwy
垦	ghtg
滢	nsxk
窕	iwii
滇	ngjk
邬	mpfw
珅	jdsw
圃	wnfw
咿	lebg
瘴	mkjz
徙	cppz
舫	utfo
嗝	lflu
泞	niad
藐	svdw
赣	kjtc
鹦	cccm
逵	hkho
戍	kkdw
榭	aqhc
牠	poen
揩	fnnd
熹	hlib
蟾	qxvb
霾	cvvl
蔫	sfpi
跛	pbpz
岐	ugbo
脐	wtka
糗	qqhq
螳	qiht
哺	lnfv
鹭	ptlm
蚣	qkna
炀	iycp
嵬	udgs
褶	xvvd
恸	rins
隽	egnh
飚	esii
玥	jwyw
籽	qkzm
釜	ksnq
剐	lcrm
鸠	rmnj
磷	vqxa
沒	nwbo
娑	nigc
谄	dxdi
巳	os
恣	ixri
猬	hvwy
酪	ptlv
丕	gfiu
溟	nxjk
隼	egih
芋	sfhc
峒	ucfl
觊	uocj
旖	tgol
筵	ggpg
娣	cqbg
婠	cibb
盹	jxwk
涸	nwjg
劾	tslh
颌	rvcb
趔	hfxm
殇	fxgc
噌	lqjj
轧	xeij
沽	njgs
愫	rhos
鸢	kmni
龇	prwn
玷	julv
掸	fqjg
趄	hjqz
溥	nnhc
疵	mpnb
皖	difl
邺	ipfe
杳	ajru
聿	bakj
镀	omsb
祎	jayi
鹉	fkpm
匍	wnfb
崴	ukfc
岖	uhsi
幔	ujub
蝈	qwjk
雒	tleh
镑	oaqt
臆	wkjr
偃	ehjc
蜗	qlcr
瞰	jylt
侬	exgy
搡	fbba
郸	qjgp
缆	kugc
袂	xbre
楮	ahjr
麼	mnaa
诠	drjw
洵	nwjr
犊	pgyo
摹	sjof
蟀	qang
邋	lwso
瓒	jpwc
苻	sehc
荦	sxpn
竣	knkt
骥	bqnk
泗	nwwr
痣	mhri
贲	gscb
胴	wcfl
潼	nkvl
弑	sakp
匐	wflv
姣	caks
谤	daqt
蘸	spei
蟋	qgqr
渥	nbdz
浒	ndgg
蛐	qcso
阂	tthm
糯	qcsr
愠	rjum
嵇	mfus
谒	djwe
绾	kibb
舀	udiz
呤	lrkb
噙	lrtn
槟	aidk
嘣	luww
诃	dalv
宓	irgp
脓	wxgy
樟	akjz
忪	rkna
蛰	frkq
咤	ligx
捱	fvhh
阜	dgid
峥	uxby
濡	ncsr
遢	jvvo
瑙	jlds
碉	vwhl
荃	srjw
孵	kkkk
讹	denb
嗵	lbso
彝	eqos
颀	dvcb
苓	srkb
咝	lkkj
篆	gets
臾	drei
椭	apew
沏	nxmd
颦	pivg
蛆	qjqc
淆	nsew
揄	frfm
嗑	lhnu
辎	xlvt
踮	pmul
犷	hmgq
荔	ssss
鳅	xmih
會	rfjj
闫	tlam
徵	cfjw
隗	pdgf
渤	ngxs
馍	xsjo
锏	otjr
楣	abjm
蜃	mqcc
遛	kvoc
倌	eibb
氤	gwod
戌	kfiw
嶙	uqxa
馗	rqqi
匮	hljc
揶	flpf
胚	wgfi
啻	aqxl
敕	altp
夙	efxx
锹	omih
珈	jslv
跂	pgbo
摒	fbqs
迩	xioc
啾	lmih
峪	ukrl
靼	sjfi
蓟	sxmd
菠	snbp
沅	nflw
馥	mjgt
槌	adoc
燮	biib
為	kgwd
褛	xqcn
贻	cnlv
豚	wtsy
礴	vsnh
氲	gjum
湍	nusr
蚱	qgub
腌	wodd
殡	fxik
毗	vnnb
耙	dkob
诽	dufy
褴	xugu
恁	emri
呷	lvjv
瘁	marg
蚌	qdfc
铝	ollv
蔻	sifb
憩	lqri
锚	osvt
濑	nalc
耘	dkin
俾	edgi
鬃	uijs
裟	nigg
祢	jxiv
苒	scht
鱿	xfov
蘅	scxi
唷	lanw
傥	eiwr
袈	slag
豺	vhgp
町	vadt
掇	fbbb
坯	hgfi
阏	ttri
戛	vjkg
贮	cifi
塾	akrh
剽	pjmd
孬	gckz
衩	xbkd
镣	ooqi
戊	kw
犟	blqp
酉	py
夥	jaxx
斡	gjrg
過	rock
匝	hujf
珩	jcic
诘	dhlv
攫	fjjb
黔	grky
潢	nsdk
臃	wake
罂	ccjf
轼	xkpg
酗	pswk
嘹	loqi
時	jhhc
阪	pdbo
璎	jccc
冗	xejm
桧	arin
闳	tena
皿	um
囡	wcnw
辍	xbbb
觎	rfwc
浚	nnkt
闰	tjwm
臼	di
蹩	qukp
煲	elai
怵	rakd
罔	cqtw
囤	wxwk
蚓	qbus
碴	vajf
姒	cekr
灸	xkih
蚯	qdfi
嗥	ldog
堑	xdht
箴	gkfl
谗	dxli
嵘	usxa
箩	guxx
艮	gg
碱	vkfl
葆	sela
還	uflo
旎	tgbn
谆	dakz
粽	qijs
牒	dsau
泸	nubs
蔺	steh
刽	rinm
锷	ollh
诋	dkxk
惇	rakz
缜	kgjk
爻	ssii
贰	kicb
坳	hnsl
睑	jrfn
葭	sbib
昀	jwir
經	oflp
妪	chsi
噫	lkjr
镂	oqcn
癸	bfod
沣	ndfs
笆	gobz
壬	mr
绉	kxbj
抨	fnqk
箕	guqz
叵	hlvf
坨	hinb
颉	hlvc
姹	cigx
赳	hwjz
琮	jijs
焊	ijng
纭	kina
淬	narg
埠	hdgi
泱	ncod
恹	rvhq
淙	nijs
榛	aomh
酵	phkz
銮	ttjy
孛	gxkz
嗳	luxb
佶	ehlv
犒	pagn
茱	spka
饪	xmrs
孪	tkzy
泠	nrkb
砺	vvfw
遽	utoc
嗟	lqpg
钙	ojfe
鲲	xjnn
谚	dkgc
闾	tllv
谟	dsjo
馊	xdub
翦	qwmv
雉	jehi
虱	ygqc
糠	qmbn
锴	onnd
赈	cmcb
骠	bpjs
旮	rjrj
峋	uwjr
跆	pnlv
飛	yf
瘠	miiw
潸	naaw
饕	lhuk
佚	egof
淄	nlvt
谀	ddre
镳	omib
廿	sfio
喟	lvwy
偻	eqcn
绺	ktul
沱	ninb
囱	dtpx
铳	oanw
兖	aknw
袤	akgg
對	iqhc
栾	tauy
畿	nnkv
诌	dxbj
赓	mbrc
苯	safi
佻	ewii
繇	ujgo
魈	diwy
屌	bluj
谲	dkgl
泾	nbpg
獗	hvqx
鞅	scod
蹶	pvqx
绔	kofh
雹	cwos
旯	jrjr
洱	nles
樣	aqkn
馄	xjnn
粲	uxbq
哂	lpxv
蔗	smsi
饨	xxwk
奘	dhod
芍	swkd
淞	nakn
腴	wdre
現	jjjw
剜	ixam
汾	nkmd
顼	jvcb
濂	nmqk
蜚	uqcf
殒	fxlc
麝	mqhc
鹞	ujmn
蚤	bkqc
浃	noqk
坂	hdbo
颚	llfc
忤	rggi
洙	npka
祗	jkxk
無	gsfi
迤	gooc
眦	jpnb
彗	ddbj
暹	jeoc
赧	hkkb
佝	ewlv
蒯	swwm
僮	ekvl
郦	fccp
钺	okei
嘞	lssl
硅	vhht
蛹	qbsy
玳	jeki
睾	guhg
赁	emcb
盂	fhum
螭	qtwn
瑁	jcij
俅	efnk
侗	ecfl
骛	kgtb
宕	ivsb
纂	gjoo
堰	hhjc
厩	vbnw
萋	sgbc
鄢	fphp
帔	ubpj
蓁	somh
杈	abkd
熨	bjhi
挞	fooc
觐	sicj
開	dfso
阗	tgjk
钏	olcj
煊	iiff
泫	nana
迳	bpoc
夔	qqpt
缮	kqql
燧	iqto
嘁	lkji
孱	bkkk
懑	nsfr
邕	llob
彧	klfc
柩	ahxk
耆	hnjr
漕	nsjj
龛	rfgp
鹄	plmn
饯	xfkg
餮	fxrk
幄	ubdz
鹘	rmng
爰	unbo
噻	lish
倨	ebjg
汜	noss
诙	deih
锃	oljw
颧	sllc
璟	jjai
纰	knnb
绡	kiwy
鏖	mtjl
瞭	joqi
氢	gbpg
颢	jaic
楔	admo
藜	smwn
郢	ljpf
妫	cksk
栀	adfa
岫	udos
谥	dqku
骧	basg
犄	poal
葳	skfc
辇	ooxj
珪	jhht
魑	dtwn
璜	jsdk
聒	llse
椿	aojr
伢	ehyr
谩	djub
琊	jhpf
骅	beng
禛	jgjk
鹜	kgtm
颍	nnvc
闩	tfim
翕	rvvx
濠	nats
仞	emkd
鳗	xjub
玖	jxkd
踊	pbsy
痿	mmcn
皈	ddbo
骊	bfcc
芑	soio
孑	kfie
撸	fxjr
帼	uwjk
檄	adtt
啵	lnbp
昶	knjr
柚	adou
祐	jelv
篑	gljc
陲	pmso
潋	nrft
亟	klbf
樽	aqph
遨	hwto
锺	omvl
舶	udbo
莆	snfo
蛀	qkjw
琨	jjnn
點	gulv
邈	vdwo
棂	abih
抻	fdss
搽	fsra
俪	efcc
铉	oana
怩	rbnb
嚯	lceh
茁	swwk
韭	ufif
膘	wpjs
酩	pxlv
榔	akbp
娩	cxlw
忸	rbcx
刎	wcmd
彿	cbka
扪	ftms
漳	nkjz
瑄	jiff
呶	lcbo
仃	eadr
呯	lnqk
佞	eicn
饬	xgsl
裨	xdgi
壹	hxfq
巽	oosk
黜	gwwk
鹂	fccm
滂	naqt
徉	cqyc
戕	dkgq
埂	hfjs
僖	ehlv
倢	efbp
纫	kmkd
奂	xcod
溉	nbnw
範	gdaj
猊	hdwr
胛	wvjy
卟	lubv
锌	okxj
遑	djoc
跻	ptka
珣	jwjr
妗	crky
蒿	sago
钛	ookd
岷	uoxi
葩	sdob
傕	exeh
磺	vsdk
魃	debk
汕	nuss
蠡	etqq
苋	scjo
肛	wpgy
剎	sakm
潞	nptl
阕	tbfo
桠	alqk
铤	omgy
涿	ntkd
薜	sblk
郃	rpfh
氐	kxkd
鲛	xaks
睥	jdgi
滦	ntau
稔	mrkr
頭	flqj
妺	cfmn
锲	odmo
徜	cisc
哙	lrin
冼	ipwr
獐	hkjz
喙	lets
讧	dpgy
氨	gicn
缯	kqjj
褓	xela
赊	crjs
菀	sixa
鄱	gqvp
炅	jihr
碜	vnoc
戗	rakg
嫫	csjo
瓴	rkbr
犍	pbag
酊	pady
臌	whgb
钠	ocre
螓	qomh
镌	oegn
麗	fcfm
铀	odoj
羯	qjwe
挝	fhoc
谡	dvkt
襁	xblq
邙	tpfw
渚	nhjr
胫	wbpg
箸	ghjr
逖	hioc
雎	jehq
砥	vkxk
衢	cjji
骞	iskb
狒	hbka
荟	srin
汛	nygi
盥	dnum
睚	jvhh
栎	akiv
祚	jgub
砣	vinb
烩	irin
氣	gqmq
夯	osld
拮	fhlv
驷	bwwr
掴	fwjk
蘩	sgeo
禩	jvsk
蜞	quqc
乜	om
殓	fxrn
灏	njac
發	bbes
擢	fvve
哔	lnng
殛	fxkf
徇	cwjr
荪	skiv
蹴	paif
疹	mrcp
鸵	minb
忾	rgqx
谯	deib
韫	ayju
祛	jhna
膻	wawf
黢	gnkt
仄	vreh
炁	hwib
唳	lhhq
烊	iqyh
孀	ccaj
斫	vdjs
腚	wifp
牍	dgyo
佃	evtr
懋	akgr
赡	cxvb
秣	mfmh
鹗	llfm
榷	axeh
镭	ocvt
铄	okiv
庾	mdre
媾	csch
嫒	cuxb
饽	xgxk
佥	rfns
谌	duei
尕	givn
啮	lprw
蝼	qqcn
闱	tayi
逡	nkto
篙	gagz
膑	widk
問	dlvm
荥	sxns
隍	pdjw
蕨	svqx
罄	hbej
郓	xxpf
囵	wrnb
橹	axjr
诰	dplv
蹇	iskp
睢	jehm
喱	lvvl
縯	oifk
間	djrm
話	blsy
肓	twyw
榈	atll
绶	kuxb
槊	qwwa
罹	ureh
瑗	junb
槁	aagu
秸	mhlv
裱	xhgy
牦	pmmn
荑	sobg
滓	nikx
腓	wufy
砝	vhna
谶	drrf
舐	lkxi
嗎	lwmv
秆	mngh
荏	semr
芈	sako
邝	mpfg
給	orhs
斛	xsig
暨	bnhf
狻	hnkt
滟	ndxo
恫	rcfl
纾	kkyj
麋	mqml
锟	ojnn
粑	qobm
诳	dhjw
氅	itmm
寮	ioqi
鹑	akmn
驽	cbbm
囫	wwcp
炷	ikjw
缙	klqj
徕	cfqm
弭	bleg
聲	hbel
橇	ammm
痢	mmmd
撺	filu
柑	asir
圜	wufg
魉	dfcr
儆	eswt
妊	cmrn
婳	cfvw
兩	fubb
矍	jjeb
犸	hbmq
哓	lxgl
酶	pgem
當	ivts
庖	mwos
缢	kqku
俎	rrjq
墉	hmbw
鲫	xbna
藓	sxqy
佰	evjr
痔	mhhc
觥	xsil
闇	dkjr
哞	lnpn
旃	tgwa
讓	basg
伉	eaej
猷	qphq
怄	rhsi
牯	pjgn
茀	sbka
烜	ifjf
锨	odxq
長	uc
豢	qots
轱	xjgj
泵	vnss
蝌	qmig
擀	fgjn
绻	kqoa
呔	lokd
绌	kwwk
蓑	safg
釉	gqdo
纥	kgyi
翳	hjev
殁	fxes
讫	dgyi
濛	nsxt
從	crrp
蜇	fdqc
砧	vulv
殄	fxrc
萼	sllh
覺	dssj
辔	kxkl
诮	diwy
胰	wobg
浔	nbhc
蜍	qrfa
緂	oiih
瘌	malm
钜	ohbo
趿	pgkd
瘀	mtri
鸪	jmng
霰	cswt
婥	cujz
赟	tfkc
祇	jkxi
鹧	msfm
邊	qito
诨	dxxj
掼	fegc
僭	ehwj
礽	jgns
動	mvsl
弁	nsoa
體	rcsq
湎	nsms
栉	asaj
蹉	pqpg
汨	njrs
醍	pjfp
磬	hbev
铂	odbj
蓼	svvc
泷	nfgp
梏	aplv
祜	jjgs
摺	fvvd
鸩	xwmn
虺	lqcw
豌	flqa
嘬	ljlb
疡	mycp
荞	smka
杲	jaur
煨	ivhf
涝	nsxs
蛔	qwlv
焖	itri
祉	jpis
魍	dcqt
锉	orrh
跎	pinb
桎	adzu
喆	hlhl
娠	cmcn
诿	dmcn
瓯	hsrw
偈	ejwe
殚	fxqg
镁	oqod
邳	gfpf
痂	mslv
胱	wilw
刍	xbjm
醐	pjwy
糅	qkga
亞	fkai
岿	uqbj
赝	veec
愎	rgjt
笳	gslv
禇	jhjr
唁	lbyv
齑	tkuf
崂	usxs
狎	hvjq
踽	pgqc
揆	fbfo
鳍	xhnj
钹	oebk
侩	erin
帧	uucb
裾	xbjg
姮	cfjf
椁	aakz
唿	lwcr
種	mmvl
澍	nhhc
崧	uakn
淩	nhkt
衾	rkyg
骈	bqso
仟	emqr
勖	cijs
咭	lhlv
谪	daqj
羸	tqyw
柁	ainb
狲	hkiv
窣	iarg
槃	ueau
蛭	qdzc
珲	jxxj
痍	mobg
猢	hjwy
俦	edhc
镫	obfq
鼹	dbjc
戡	uekg
悌	rqbg
嬅	csns
濯	nvve
懔	rawj
莅	sekl
裡	xvly
肊	wyiy
咩	lqyv
誊	qoby
見	jj
卻	krla
鳝	xqql
韪	jfpy
嫪	cvvc
亓	flji
铩	osau
噱	luts
燏	ikgl
硌	vtlv
俚	evlr
椤	auxx
臉	wrqy
脍	wrin
淖	nujz
炘	idjh
汞	pnsg
姘	cqso
聩	lljc
泅	nwre
喑	lkjr
铡	ocmd
绦	ktau
恽	rxxj
桫	anig
薏	skjr
遒	qpoc
痨	msxs
屙	bpal
蚪	qigi
佫	etlv
窸	igqr
蒺	smji
蚡	qkmd
觞	xsgc
葺	slle
煅	iele
茕	sxyg
悱	rufx
肜	wcpy
沨	nesi
棫	aklf
靛	hwip
诓	dhjw
忝	foik
拋	ffsl
箔	gndb
璠	jgqv
芃	sekd
別	lwmd
珥	jlew
菅	sibb
嶷	unjp
酃	cllp
與	dhjk
臬	qaui
岬	uvjs
舢	uuso
肱	wena
焙	iklv
逦	fcco
啖	liih
冁	qjgh
鸷	frkm
蜢	qkum
莠	smgn
級	ogkd
茔	sxht
铨	orjw
槚	apcb
旻	jter
胺	wicn
雲	cina
堇	sirg
變	boot
艽	srjo
湟	ndjw
瑭	jmbl
踅	fdpz
芨	sgkd
嶂	ukjz
逶	mcoc
幾	nnkr
钾	ovjj
跹	pmoc
徭	cujf
狍	hwos
鹌	odmn
笞	gnlv
埙	hlcb
仵	eggi
缛	kmhc
椽	aets
暝	jxjk
酮	pcfl
苕	smlv
婺	kgtc
貉	vtlv
玠	jrka
糨	qblq
囿	wewy
帏	uayi
铖	okyi
畹	vixa
镝	oaqj
缦	kjub
铣	opwr
轸	xrcp
將	dwhc
舂	odip
碘	vcsk
黍	mrns
芫	sflw
馔	xook
碁	uvsq
铢	opka
槿	asir
赭	hkkj
涪	nklv
塬	hvdi
氯	gbns
倬	eujz
酡	pinb
實	iegj
颏	tvcb
傣	eons
媞	cjfp
缱	kljo
浜	ndfk
暻	jjai
篾	gukk
鋆	hwit
柘	avsu
猕	hbxi
桉	aicn
砒	vnnb
邶	qnpf
洌	nfxm
衿	xrky
颛	usvc
蜮	qklf
骢	bdtr
柒	nxau
郅	dpfz
呖	lvsl
饴	xnlv
圩	hfhc
茯	sehq
疱	mwos
圄	wfbl
琚	jbjg
橐	glxa
钿	ovtj
枸	awlv
貅	veau
蛎	qvfw
嫱	cgql
爿	dq
進	eoch
辂	xtlv
綦	uosq
笤	gmlv
唢	licb
旸	jycp
鼬	dbdo
苜	sjmo
窠	ijau
嗄	lvjt
卅	ss
艄	uiwy
苡	sekr
茏	sfgp
囹	wrkb
辚	xqxa
撷	fhlc
伥	encr
毐	heez
疟	mbjb
骓	behm
筌	grjw
屐	bcgb
猁	hmmd
靈	cllr
傩	ebeh
帶	sfxu
疽	mjqb
珙	jska
貊	vvjr
诟	ddfl
鬣	ulwb
鼐	gjdd
剛	cqum
嗞	lqnn
獭	halc
獾	hsle
洮	nwii
邛	ppfg
擤	fqvl
赅	cthb
黒	vibl
咴	leih
稗	mdgi
楂	aajf
氮	giih
竽	gfhc
箓	gbns
勐	kusl
碣	vjwe
谔	dllh
逑	fnko
铧	oeng
郾	hjcp
師	dfuj
铆	okmj
褡	xsrh
滁	npra
陂	pbpf
喁	lvyv
矠	kgsj
湫	nmih
蚺	qcht
钨	omwj
钲	ofpi
綮	htos
蕲	sqjd
噹	livt
遴	qxao
舛	xakx
荠	stka
玕	jngw
稞	mjau
阄	txdd
荚	soqk
媪	cjum
鎏	nant
悒	rlob
迡	bnoc
笏	gwcp
郗	seup
晷	jtul
戰	lljk
宥	iewy
豸	vz
摈	fidk
儋	exvb
葶	saad
瑸	jidk
愛	uxrt
凫	mejn
阡	pmqf
猗	hoal
粕	qdbm
蚨	qofc
纛	hejo
畲	rjvt
睇	jqbg
滿	nsfb
洇	nwod
難	sfle
裏	avgy
醮	peib
龍	kwub
癣	mxqy
虢	uhuh
葻	sefo
踯	pqop
酆	uddp
诒	dnlv
珐	jhna
內	cbuk
颎	nivc
馏	xkvt
髭	upnb
莛	smgy
龈	prwg
锒	okgg
钯	oobj
楹	agbu
贽	frkc
菖	sjjr
虻	qtwc
灞	ncsw
聽	ljgr
苌	snco
躅	puwq
牝	pnbn
钎	omqj
畦	vhht
珺	jbgl
欤	hfxq
腩	wgcg
桁	acic
該	bthy
吖	lqus
屍	bfxn
蠹	glxq
眬	jfgp
夢	suxx
張	bucg
瓤	asgu
淝	nwob
鸶	kkmn
亳	agxi
應	meer
楫	alle
薨	suxn
祂	joes
訇	wbyb
镊	olbb
陟	ppiv
炰	woib
靜	hwuy
镗	oiht
樗	acfh
苫	sulv
阆	tkgg
莒	sllv
稹	mgjk
罅	jugh
豕	ts
涫	nibb
螟	qxjk
骝	bkvt
連	docc
蓿	siej
苎	sifi
祧	jwii
擘	blkf
犴	hngq
玎	jadw
侉	eofh
學	dssk
仝	rpge
厝	vsjr
馐	xqbc
潍	nkeh
邰	nlpf
兕	clwk
赍	grrc
龅	prwo
黩	ggyo
霂	cnau
胪	wubs
诤	dxby
抟	fiek
鬈	uqoa
結	ohlv
烺	ikgg
裝	dhag
芪	skxi
莳	sjhc
毽	mbag
筇	gppf
忺	rxqx
猞	hrls
腱	wbag
砭	vgoz
挈	dmfs
澧	ncsq
怼	bhri
镞	otgj
貔	vdsn
嬗	cawf
醴	pcsq
搠	fqww
薹	shld
杷	aobu
杌	alwu
並	qiek
風	ef
讴	dhsi
铬	otlv
闼	tooc
拊	fehc
歃	mdxq
機	annr
輕	dflp
沆	naej
蝮	qgjt
晞	jseu
飏	esyc
烷	iifl
箜	gipg
彀	hfbg
揿	foxq
雠	edeh
傳	edhc
荩	sbki
恂	rwjr
燊	iiia
茴	swlv
癯	mjje
吔	loev
國	wklf
備	esgs
闿	tuoi
衽	xmry
鲈	xubs
紅	opgs
昴	jkmr
缟	kagj
廪	mawj
圻	hdjt
垓	htht
瘙	mbkq
奁	ohsi
痫	mtau
黟	gxxx
讦	dngy
矾	vekd
氖	ggnq
铰	oaks
葉	ssau
烯	iseu
陉	pbpg
耄	hnmm
妯	cdon
強	bnqc
菟	sxlk
踟	pjlv
鲧	xgos
镛	ombw
镱	okjr
峄	ubak
竦	kalv
搦	fbii
鳏	xuns
吡	lnnb
飨	kgks
猡	huxx
痼	mwjg
讣	duby
荭	skpg
龢	rcmh
殺	saes
枰	anqk
馕	xglg
鯶	vxdc
黼	iqun
氂	ftvm
鄯	qqlp
檫	aiwj
鲇	xulv
酽	plqg
垅	hfgp
佤	erwr
骘	ppib
歙	rvvx
頫	wiij
妁	cwkd
處	utej
垩	lqht
蠃	tqcw
锆	oplv
枇	annb
鄞	sipf
乩	ulei
幂	xjou
遠	hlgo
場	hjfc
蟊	kgqq
沭	nakd
綪	ohwy
垭	hlqk
萁	suqo
鹳	sllm
伧	eraj
苁	srre
盱	jfhc
恚	hhri
鼋	flld
钤	orky
門	dm
矬	jrrh
帑	cbuj
關	dnnw
車	dc
劍	rmdq
兒	dwri
轉	ddhc
離	twce
溦	nuft
侪	etka
穑	mgql
極	aklf
脶	wlcr
娌	cvln
煸	ihce
砀	vycp
陣	pdcf
孳	qnnk
吶	lcbu
蚋	qcre
缁	klvt
脔	tcrr
箬	gsel
颙	vvcb
豔	uddu
樯	agql
麂	mejl
糸	os
猱	hkga
跸	pnng
甑	qjqr
掮	fhwy
榘	jhba
岈	uhys
芾	sfuj
龃	prwj
炆	iteh
趸	fwpz
沔	njey
涘	nnji
蹰	pvfh
冄	cirk
苣	shbo
郧	lcpf
萸	sdre
裢	xxoc
緊	hbos
嫇	cxjk
捭	fdgi
謇	iskb
湉	nrls
笫	ggeg
雖	lqeh
妣	cnnb
枞	arre
禟	jmbl
啁	lwhl
疥	mrka
氰	ghwy
驚	swlw
蒹	sqbk
檑	acvt
誰	behy
莴	slcr
禳	jasg
缌	kvri
鹬	kgcm
夤	xifk
婄	cklv
勣	hjsl
镏	okvt
玢	jkmd
終	otir
馬	wm
狯	hrin
焐	ifbl
傢	eits
縻	mosa
屃	bcbs
莜	seut
魆	dkei
鲑	xhht
腭	wllh
淦	ntjs
砦	pnvs
洹	nfjf
荇	scic
鲠	xfjs
蚝	qmmc
榉	anka
楝	aawq
艨	usxt
楸	amih
鹈	qbum
睃	jnkt
棹	aujz
昇	jgso
瀣	nuxf
龉	prwl
鬻	bqbu
東	ajru
庥	meau
骐	buqm
囗	ww
筢	gfob
柝	adkd
靺	sfmg
堀	hbww
磔	vxaa
柞	agub
膂	tggw
鞨	sjwe
谘	dixl
锰	okum
協	gsss
泔	nsir
聃	lcht
堞	hsau
徂	cjqc
蟥	qsdk
羕	qkns
墀	hbnp
薅	scmh
艟	ukvl
怿	rbak
窳	iuug
嵯	uqpg
呎	lbkd
彘	enjn
蛳	qqfu
迨	nloc
犰	hrjq
橛	avqx
篦	gdsn
荜	snng
跶	pooc
焯	iujz
儁	eeck
趺	pofz
倥	eipg
鸹	lmns
瞇	jqoc
椋	aaiv
崃	ufqm
記	boiy
芩	srky
芡	sxqo
旒	tgaw
請	bhwy
蝺	qgqc
耧	dkqc
庠	mqyg
眾	uerr
狴	hnnh
钴	ojgj
侂	emgx
樾	ahke
镕	oirl
欸	njxq
穰	masg
螯	hwtq
耒	dkaf
眙	jnlv
肄	njba
菈	sfkl
隨	pepo
罴	uhni
怛	rjfi
缃	kajm
哏	lggv
逄	taoc
岙	musy
沤	nhsi
荨	sbhc
珰	jibj
圉	whqg
娈	tcny
叻	lslv
訢	bdjy
耋	hndz
鸮	lhmn
雙	eebo
邴	fcrp
擊	dwef
毂	hxjs
铱	oagy
傷	egjc
俳	eufr
艏	uqqi
喈	lnnd
蓠	stwn
類	qhvj
薮	sqct
貘	vsjo
崤	usew
峤	umka
珮	jefu
笄	gfso
蕤	stps
蹁	phce
缗	koxj
條	euta
秫	makd
璁	jdtr
渑	nldd
掾	fets
祆	jfod
吋	lhcv
醪	pvvc
豉	flqb
搧	fhvv
郿	bjpf
庑	mffo
茛	sggo
莼	skxw
挹	flob
筮	gprr
阒	tjhq
媸	cwfq
怫	rbka
鲔	xewy
許	bggi
疣	mfob
認	bmkr
姰	cwjr
雱	ctfy
镍	oqau
團	wdhc
褫	xduh
潾	nqxa
锛	oogs
轳	xubs
鲵	xdwr
萬	svyo
熵	iaql
錯	tsjr
馑	xsir
謝	bqhc
眇	jigp
瘆	mnoc
電	cddy
轺	xmlv
塄	hutf
續	ohuj
涞	nfqm
纔	oxlk
杼	akyu
讬	dgxi
沖	nlus
崮	uwjg
岘	ucjs
纮	kena
诂	djgy
镢	ovqx
鲶	xrkr
玦	jbre
鲮	xhkt
氟	gbka
蔌	salx
鐵	tgkj
椹	auei
洄	nwlv
僜	ebfq
栊	afgp
沴	nrcp
郏	oqpf
孢	kwos
侑	eewy
郴	aapf
詈	ubyw
獬	hxsp
澶	nawf
興	dcfk
箧	ghoq
語	bfbl
朮	akdu
鳃	xvri
嗐	lidl
線	odns
矸	vngs
讵	dhbo
枋	atfu
璺	dcfk
啭	lxik
澌	nudj
鞣	skga
幫	hhhu
黻	iquk
蜉	qukz
鳥	dn
樘	aiht
耦	dkvy
虛	uwfi
跖	pvsz
蛉	qrkb
箪	gqjg
璈	jhwt
歡	sllx
逋	nocf
扦	fmqs
愆	cnir
孃	casg
跩	pdgp
鳟	xqph
浠	nseu
藿	sceh
泚	npnb
痱	mufb
憷	raap
殳	es
隊	pqts
葚	suei
纡	kfhc
翮	flcv
戋	fkgi
喦	lllu
黧	mwgg
錢	tkkg
诔	ddka
鲽	xsau
絕	omob
矇	jsxt
曷	jwre
題	jfpj
髋	risc
狳	hrfa
毖	nnrg
藍	shgu
坻	hkxk
哚	leau
槎	aqpg
乂	si
铙	oxgl
蜊	qmmd
袆	xayi
嫘	cvos
骟	bhvv
漯	nvos
捌	flsm
瓘	jsle
椴	aele
墒	haql
阋	tdwr
蹚	piht
牖	dhnf
溘	nhnu
阇	thjr
龋	prwc
愍	oxtr
篁	gdjw
刈	smdi
悭	rubh
樂	dnna
蠲	qkuq
谝	dhce
郞	kgpf
總	odtr
撄	fccc
鬲	flcu
瓠	ofhu
畠	dvtb
麸	htof
棰	amso
圪	hgyi
錾	xdtj
洺	nxlv
笮	ggub
轾	xdzj
嬛	cufg
砷	vdss
衛	cbic
杓	awkd
锱	olvt
餍	vhks
剀	uomd
辦	kskx
疴	malv
寤	idfl
瞽	hgbj
芎	sbgo
糍	qqnn
缡	ktwn
蹼	piqo
鳕	xcbj
尻	brjs
捩	fhhq
陸	phkh
裰	xbbb
偬	ewcr
窨	ikjr
幛	ukjz
榫	aegi
茑	smno
唸	lrkr
蓊	sknv
峁	ukms
鏊	hwtt
秭	mgeg
屄	bixs
瘢	mues
茼	scfl
鲅	xebk
郜	plpf
旄	tgmm
芰	sgbo
汊	nbkd
茝	sheo
殍	fxuk
樨	abnp
摭	fmsi
碇	vifp
涑	nalv
钡	ocbj
凼	nwks
垆	hubs
蟮	qqql
炔	ibre
萘	sojs
蓍	shnj
飧	xksx
岢	ualv
俣	elfo
碓	vehs
數	lglt
刿	uxmd
龁	prwy
孓	kkde
谰	dtaq
蕖	snha
痧	mnig
暍	jjwe
霈	cnfu
唵	lodd
訴	bdkd
槲	axsg
钚	oguj
叆	inub
嫚	cjub
聖	lljw
腦	wlds
異	vska
亂	ubce
铗	ooqk
痈	msyb
绐	knlv
媗	ciff
狷	hlwy
埚	hlcr
層	bqjj
酢	pgub
漸	nddj
阍	tkxj
梼	adhc
準	negi
螫	hkkq
欹	oalx
傈	epau
榊	ajds
赀	pncb
壅	akgh
怙	rjgx
渌	nbns
紒	orka
癔	mkjr
傒	euno
嚇	lhkk
莪	sgfk
冴	ihyr
視	jjjs
潆	nsxo
吽	lpnv
逯	bnoc
腳	wkra
浞	npzs
镠	ovvc
檩	aawj
熱	hkhi
蔸	sdkw
痤	mrrh
親	kajj
嘚	lcjh
翥	hjvv
毬	mfnk
菽	sjib
鸱	kxkm
戲	uflk
黥	gaiv
昉	jtfr
酰	ppwr
茭	saks
盍	hnum
圍	wbww
赉	fqcb
藥	sdna
珽	jmgy
霪	cnum
淰	nrkr
菏	snal
禵	jjfj
诹	dlbo
柟	acht
夠	xxwl
園	whlg
苴	sjqo
溿	nvqa
滅	nkfi
粳	qfjs
復	cgjt
蹓	pkvt
糌	qtuj
欷	seux
樹	ahhc
惡	fkri
亶	awlf
義	qgfk
趵	pwkd
護	bseb
舸	ualv
蛩	pekq
枥	avsl
決	nbre
蘼	smuf
娰	ceer
蕈	spjz
搖	fwjf
襦	xcsr
膈	wflu
芏	shto
畈	vdbo
笊	guzz
燠	idqo
艉	ubmm
阊	tjjr
厣	vhvj
鸬	ubmn
傧	eidk
攮	fglg
艿	sgno
酚	pkmd
璘	jqxa
塍	wqoh
叇	inbo
厶	na
椟	agyo
氦	gthq
菰	skug
笸	ghlv
疸	mjfi
镪	oblq
圮	hoit
禤	juvv
幪	usxt
醛	psrj
佈	eeuj
髡	ulwb
砲	vwos
篌	gebj
谖	dunb
謦	hbeb
徼	cdtt
醯	panu
裣	xrfn
枳	alka
豽	vcre
懷	raug
則	jmdb
蓖	sdsn
髫	umlv
酯	pnjr
較	daks
訾	pnby
暾	jakt
勢	hkhs
確	vxeh
趕	hjng
繼	onne
碛	vhcb
缳	kufg
镒	oqku
斷	nnfd
孥	cbkz
硖	voqk
溧	npau
柢	akxk
糁	qnoc
镬	oseb
皴	nktb
卺	ynfa
虼	qgyi
鋈	nmtj
帙	ugof
軍	xdcm
箝	gfsi
鍪	kgtt
锞	ojau
蘧	suto
祩	jpka
丌	lj
樓	algc
泮	nqak
倆	efub
鞫	swby
觀	sllj
溱	nomh
簟	gpjz
眭	jhht
昳	jgof
棽	aary
坩	hsir
窫	idmo
寶	ijjj
鄄	phpf
旉	ntff
隱	pupr
嬖	blkc
砻	fgvs
隰	pjni
郯	iipf
報	hqgb
劻	hjsl
衹	xkxi
單	lljg
廋	mdub
熜	idtr
祼	jjau
薙	sjeh
約	owkd
朐	wwlv
尋	bplh
筚	gnng
爾	fkus
厓	vhht
墼	dweh
跬	phht
愀	rmih
識	bkjk
嘡	liht
毀	dhes
醚	pqoc
鳜	xvqx
萑	seho
幹	gjrn
恆	rfwf
缍	kmso
蚧	qrka
麇	mmhl
柰	ajsu
遄	usoc
姽	cxva
戆	kjtr
達	hqoc
竑	kena
琤	jxby
趱	hpwc
湣	noxj
鲂	xtfv
黃	sidk
壞	haug
垸	hifl
禔	jjfp
螅	qqri
細	ovts
玭	jnnb
爔	iqmk
煇	ixdc
試	bkpg
裎	xljw
埸	hjwc
態	nwnr
槠	adhj
務	kgts
儇	eufg
卮	dfaj
靚	hwjj
淚	nhhq
肽	wokd
顯	jnnj
筲	giwy
绀	ksir
顸	nvcb
盉	mumh
菸	stri
倮	ejau
崁	uhxq
媵	wqoc
弐	fkir
岜	uobs
谵	dxvb
澣	ngjn
帻	uhcb
創	rkbm
瘐	mdre
褊	xhce
鲟	xbhc
簋	ggum
梃	amgy
缵	kpwc
屣	bcpp
陽	pjfc
礅	vakt
墡	hqql
缶	jf
矟	kgiw
甪	gsyp
鹚	qnnm
缒	kdoc
亍	ic
煙	ipht
塊	hdgt
刖	wmdy
澂	nuft
炻	ivsh
鹡	iirm
卬	kajm
絲	ooss
瞋	jgjk
焗	ibyl
荽	sucn
鼍	llvd
瘿	mccc
锶	ovri
砬	vkls
磴	vbfq
閒	dwym
跣	ppwr
疖	majb
閃	drem
迓	hocy
況	nlwr
練	oawq
炝	iraj
鐘	tkvl
啉	laau
硒	vpxs
擁	fake
汔	ngyi
貓	vsvt
驺	bxbj
伛	ehsi
蛄	qjgc
绂	kebk
鞯	ssek
燹	ttih
禦	cgfj
髀	rdgi
缫	klja
凇	iakn
銀	tggj
翀	vvlu
羖	qesy
銎	pekt
濬	nuxj
跗	pehc
羏	qcpy
鏦	tcrp
襌	xllg
綠	oens
寫	idwi
唎	lmmd
調	bwhl
爲	ugwz
嗉	lhos
铘	ohpf
殂	fxjq
鞮	sjfp
眀	jwym
饫	xmys
盡	bfiu
鼙	hgbg
辏	xofo
檗	blka
悛	rnkt
璩	juts
沚	npis
純	oxwk
彟	bhsb
煳	ijwy
笕	gcjz
鲥	xjhc
褙	xqnw
殘	fxkk
锍	oanw
尥	fwkd
劢	fwsl
淒	ngbc
嵊	umqn
隻	eboh
轫	xmkd
饧	xycp
抺	ffws
佾	ekwy
谳	dgch
鸰	rkbm
鲩	xifl
書	bhjr
觚	xsug
苷	ssir
棼	aakm
嫈	iixc
萏	sxdi
佺	erjw
媽	cwmn
熘	ikvt
羝	qkxk
鹕	jwmn
觜	pnxs
睏	jwau
蘖	sdka
溫	nwru
満	nscu
喾	nxpl
剡	iimd
響	kgkj
號	lhuh
譞	bufg
爭	ubyi
椐	abjg
鍊	tawq
狝	hxiv
麴	atwq
曩	jasg
蚍	qnnb
髁	rjau
誗	bmmd
瑷	juxb
砗	vxjs
領	rkbj
阃	twau
怱	wckr
溲	ndub
桡	axgl
匏	ofho
狺	hbyq
鲢	xxoc
耨	dkmh
煖	iunb
鋹	tucj
傑	exaa
豳	utts
燒	ihhl
舨	udbo
疋	ypzi
缑	kebj
猓	hjau
蝾	qsxa
愦	rljc
員	ljbv
榧	ahuf
洫	ngum
蹾	pakt
搴	iskf
蚜	qhyc
荸	sgxk
坜	hvsl
釐	ftvv
磙	vakg
粜	wwqm
螈	qvdi
摀	fdws
踫	pqie
轭	xvaj
绨	kqbg
庋	mgbo
詝	biad
抔	fgus
珃	jcht
魚	vv
計	bgiy
皲	xxbp
胝	wkxk
麈	mkjw
蕗	sptl
犼	hkei
铍	obpj
滹	nugh
锔	obyl
蝣	qtgk
邗	npfg
跏	pslv
論	brfc
習	vvdb
誄	bdka
寔	ijfp
網	ocqt
鲋	xehc
柙	avju
硼	vwwy
罘	uguw
鸫	ximn
浤	nien
勰	sssr
疝	musb
獍	hkjw
葸	svri
扃	hclv
痋	mqcb
皤	dgqv
掛	fhhu
笥	gyfl
鹾	uwsp
潲	nmiw
憶	rkjr
旰	jngr
賣	hujb
溏	nmbl
鲱	xufv
險	prqf
燝	ijai
偾	egsc
溽	nmhc
揎	fiff
伲	ebnb
禮	jcsq
剞	oalm
晳	adjr
秾	mxgy
锗	ohjr
悝	rvlx
漭	nshs
寘	igjk
痦	mfbl
華	snso
屬	bnuq
狀	dhqq
礻	js
嘆	lsfo
袢	xqak
樛	avvc
鳎	xjvv
願	vdij
桿	ajng
昝	tujr
嘏	jbib
咹	licn
滏	nksq
釋	gqug
廨	mxsp
薩	spkp
觳	hfxs
璔	jqjj
綝	oaau
桷	axsy
黙	vhib
戢	llkg
舻	uubs
彖	etsm
郛	ukpf
羅	uoeh
買	ujbw
袛	xkxk
脘	wifl
蓐	smhc
裉	xggy
疠	mfwb
艋	ukum
業	iqka
锜	ooal
綎	omgy
嬲	vscs
獨	huwq
粝	qvfw
郇	wjpf
歷	vmmp
參	nnnc
鹩	oqjm
厲	vsvy
蠱	qqqu
耜	dkbb
迴	wloc
栌	aubs
紓	okys
坼	hdkd
陰	prkn
埕	hljw
髮	uebk
鹪	eimn
砩	vbka
瘊	mebj
洳	nclv
尜	ioiv
宄	irjb
嫠	ftvc
蠓	qsxt
筥	gllv
愔	rkjr
铊	oinb
墁	hjub
廝	mudj
埒	huhc
脫	wklw
锂	ovlj
講	bsch
蔟	stgj
劬	wlsl
剋	jwmd
蹀	psau
颟	sfcc
飯	kdbo
濞	nqvl
誘	bmgn
飄	pjef
曈	jkvl
醫	hjep
悃	rwau
谮	dhwj
唣	ldxi
蠖	qseb
係	egos
祕	jrgp
鲎	nxxv
紛	okmd
畀	vljt
裒	adgy
咥	ldzv
磾	vllg
訞	bmyy
锝	ojfh
郫	dgpf
伕	eofr
淯	nanw
镲	oiwj
蚬	qcjc
煩	ivjb
讚	bpwj
臜	wpwc
嗍	lqww
奭	ovjj
邡	tpff
頂	avjb
阈	tklf
赜	hhcb
螨	qsfr
組	ojqs
蟲	qqqc
怍	rgub
歲	pkfi
爌	imsk
鄣	kjpf
鳐	xujf
歔	uixq
遊	tgko
嚐	linj
拶	flxx
敵	aqct
狁	hnwr
陔	pthf
汆	bnsu
擺	funn
觯	xsqg
矽	vxxs
呣	lemv
卍	yufu
卐	efuf
绹	kwjf
託	bgxi
鹣	qbum
涬	nhqg
磲	vnha
湜	njfp
颡	bbbc
钼	ojmj
肏	bcrr
勝	wqos
袴	xofh
呒	lffo
換	fxco
顧	hevj
齮	poal
皞	ddog
彈	bllg
棗	acac
眄	jjey
冇	eckz
搛	fqbk
畋	vtpt
蝰	qohh
慊	rqbk
肫	wxwk
劁	eimd
貴	ljjb
崦	uodd
夾	orre
陳	pajr
順	lvjb
塚	hxtk
酹	puhc
冏	cklv
幷	gngn
瘋	mefb
雮	cmmy
慘	rnnc
髒	rsfs
術	caki
胼	wqso
簏	gmlz
脩	eutw
皝	djil
瘳	mvvc
蝓	qrfm
锑	oqbg
稱	much
舁	dsoi
暌	jbfo
壓	vjwh
佔	eulv
诜	dpwr
尢	fo
芗	skgp
瑨	jlqj
選	ooso
尙	is
墬	peth
菔	swab
瞾	jjip
蟻	qqgk
琍	jmmd
旆	tgfu
焓	irkl
胙	wgub
蒌	sqcn
愬	qwwr
犨	eepn
癡	mnjp
畢	jsak
靸	sgkd
浈	nucb
癒	mrfr
碡	vhem
缣	kqbk
觇	ulcj
颞	lbbc
唦	lnig
簡	gdjr
擔	fxvb
埽	hbxu
丟	jnaw
谠	diwr
補	xnfy
楙	akga
聯	lnnw
倖	ehqg
衝	cmvi
牆	dhrl
栲	ahhk
統	oanw
猲	hjwe
鑛	tmsk
鞬	sbag
僳	epqm
芟	seso
鲷	xwhl
俶	ejib
袼	xtlv
踔	pujz
產	tvps
槭	akji
紙	okxi
呡	loxi
磻	vgqv
鲞	qoxv
蚴	qnsl
討	bhcy
邠	kmpf
哢	ljso
蒉	sljc
桴	aukz
佧	ejub
囟	dsix
檠	swla
飑	eswo
疃	vkvl
狨	hkez
伷	edor
鲊	xgub
費	bkjb
觫	xsal
騙	whce
燔	igqv
琇	jmgn
誴	bijs
栘	axxx
俵	ehgy
骔	bijs
幞	uiqo
賓	ifij
唑	lrrh
溴	nqhq
苊	svaj
騔	wjwe
玡	jhyw
掊	fklv
溷	nwts
獚	hsdk
鲆	xnqk
囉	luoe
鮮	vqyv
舉	dhja
榇	akau
骖	bnoc
癜	mbse
畚	novt
浼	nxlw
硗	vxgl
隹	eh
塵	mhtl
堠	hebj
泖	nkms
質	ddjb
帥	dujd
睺	jebj
哿	slal
僦	eaif
釭	tpgj
瑠	jkvt
硷	vrfn
隈	pvhf
沢	nbkd
碚	vklv
馓	xswt
劉	ktmd
盤	ueum
側	ejmd
罱	ugcg
奮	oevt
戀	boor
隳	pepk
熦	iieh
怃	rffo
嵫	uqnn
僴	edjr
篼	gdkw
揮	fxdc
採	fuau
偙	eaqu
鐇	tgqv
捽	farg
凊	ihwy
揲	fsau
辊	xjnn
彳	cc
觌	gyic
垴	htwk
呑	mlvy
垕	dflh
區	hlll
篥	gpau
設	besy
绱	kisj
诎	dwwk
醢	pelu
虮	qejc
艹	so
昺	jfcr
蟗	glxq
埘	hjhc
陬	plbo
菘	sakn
養	qokg
蠼	qjjb
锩	oqoa
翚	vvxx
羑	qxkd
圯	host
弒	sakp
祓	jebk
啫	lhjr
倧	eijs
櫻	ajjc
糺	oeis
锕	opal
負	xjbm
赑	cccb
砼	vrpg
蚶	qsir
佷	eggr
侔	enpn
戥	jpkg
談	biih
課	bjau
偉	ebwr
絷	frko
藁	saau
檛	aroc
呙	lcre
靘	hwxo
豬	thjr
鳳	efdn
鏡	tkjw
擋	fivt
硃	vpka
牾	pfbl
镡	opjz
丅	jx
崐	ujnn
佴	eler
杪	aigp
昃	jvre
瞢	suxj
籴	bqmu
遹	kgco
釆	gqmp
節	gbna
揠	fhjc
搥	fdoc
堅	hbht
缧	kvos
耪	dkat
訝	bhyy
鬏	umih
弻	bfwb
淏	njfo
橼	aket
畫	bhvf
雜	arre
騎	woal
須	cvjb
萩	smih
蓋	shnu
蛶	quhc
爨	dcfi
狃	hbcq
诼	dtkd
伋	egkd
敗	jtpb
鹆	krlm
嘌	lpjs
嗌	lqku
蛴	qtka
頓	xwvj
雩	cfhk
畎	vhqt
議	bqgk
楯	adgj
驩	wsle
詩	bhhc
蕞	sjlb
輪	drfc
殭	fxff
顫	awlj
盪	njfu
皊	drkb
脬	wukz
萊	salo
鍼	tkfl
羼	bqqq
缬	khlc
賞	ijbs
漶	nllr
圖	wlgl
叡	uxfb
谇	darg
荛	sxgl
哕	luxx
奼	cgxi
驗	wrqm
適	aqco
丏	jeyi
嚴	llvt
罵	uwmw
鑽	tpwj
廣	msdk
廛	mvkh
埳	hxdi
狔	hbnb
烃	ibpg
焌	inkt
黾	lddv
蒽	swor
懼	rjje
氚	glcq
甍	suxr
袷	xrhy
铵	oicn
魽	vsir
铓	ostw
鬯	swnb
鵰	whld
躞	pbib
襻	xasf
濃	ncsm
緣	oets
嗾	ltgj
岵	ujgs
柽	abht
氽	rnse
绲	kjnn
诖	dhht
涼	naiv
遘	scho
镉	oflu
垍	hqit
錱	tjjw
據	futs
責	hjbs
價	epjb
説	bqlw
環	jufg
钣	odbo
蹤	pcrp
豨	tseu
媺	cuft
麍	manw
骯	raej
逭	ibbo
栱	aska
漢	nsfo
莰	shxq
崑	ujnn
徳	cgur
觖	xsbr
徹	cant
禊	jdmo
茌	sehs
疔	madb
圬	hfhk
潔	ndmo
茍	swlv
預	kvjb
刳	ofhm
嗻	lmsi
蝤	qqpy
虿	fwqc
睜	juby
呋	lofv
匦	hxrj
秕	mnnb
葑	shhh
铯	oxob
嫽	coqi
玹	jana
堃	ttht
豇	flqp
圓	wljb
蒼	srkl
慄	rpau
槍	arkl
資	ixjb
洧	newy
垧	hdxt
顏	tvcj
婑	cmcn
蠪	kwuq
贇	tfkj
亻	er
吣	lriv
紜	oina
跡	ptyz
劃	bhvm
钪	oaej
緩	ounb
緾	ovvl
倐	euti
窬	irfm
浯	nfbl
桕	adiu
埴	hgjq
眚	pjms
惝	risx
橫	asik
甙	ksir
彊	bfvf
歐	hllx
崞	uakz
憐	rqxa
蛞	qlsc
颃	aevc
昽	jfgp
觔	xssl
牤	ptwn
臨	hgll
貏	vdgi
嫋	cbii
邧	flpf
蚵	qalv
瑧	jomh
獄	hbhq
镆	osjo
薷	scsr
嫜	ckjz
茺	sanw
蕻	susk
爛	idaq
闶	taej
瑢	jirl
騄	wbns
罷	unwn
囝	wkzw
撫	fgsi
骍	bkxm
郕	kypf
厊	vhyh
蚰	qdoc
蒗	snkg
礡	vsnh
紞	oxwr
嗙	laqt
敉	qtpm
焜	ijnn
呿	lhna
階	pnnd
標	apjs
鳔	xpjs
骶	rkxk
圹	hmgt
巉	uxlk
褲	xmdc
幣	quku
轵	xlka
枹	awos
簦	gbfq
霑	cnul
畛	vrcp
黹	iquk
鎗	trkl
徬	caqt
瞀	kgtj
晡	jnfr
啍	lakz
荘	sqhs
貐	vrfm
湔	nqwm
跦	ppka
鲀	xxwk
燈	ibfq
揚	fjfc
閉	dhgp
扌	fs
聞	dlem
镚	ouww
歸	dpbu
龀	prwn
砉	dvsf
篪	gduh
芄	srkd
鞔	sxlw
觸	xsuq
猃	hrfn
甡	ppss
甾	lvtc
仳	ennb
島	dusn
溆	nrfb
啯	lwjk
枱	anlv
髂	ritl
锘	osel
钭	oigi
髙	auil
硪	vgfk
潴	nhhj
權	asle
髑	ruwq
蘋	spij
胗	wrcp
湊	nofo
宮	ildx
屺	uois
裥	xtjr
郐	rinp
維	oehs
垱	hibj
弢	bwbo
紀	oois
猰	hdmo
邨	xwpf
肶	wnnb
碖	vrfc
瘘	mqcn
衖	cski
賽	iskj
伾	egfi
劵	qosl
專	dhcc
沬	nfws
翃	envv
紮	aeos
枵	alhk
笪	gjfi
鲼	xgsc
镙	ovos
崾	upcn
沩	nksk
绁	ksij
翙	uxvv
甯	irsy
龆	prwl
鲭	xhwy
羟	qbpg
腧	wrfm
髌	ridk
紡	otfs
邏	uoeo
悫	hxer
蛏	qbht
罾	uqjj
溻	njvv
舳	udoo
晢	fdjr
湧	nbss
曉	jhhl
勁	flps
稜	mhkt
遙	wjoc
岡	cqus
紘	oena
氆	mqij
莊	sdhs
優	evwt
忉	rmdx
樑	anma
餵	kvhf
笭	grkb
氵	ns
蜱	qdgi
蹟	phjb
敫	dttp
猸	hbjm
爝	iuuh
褔	xflv
竐	kesl
蛱	qoqk
舯	ulus
锸	omdi
鬆	uakn
孒	kfie
钒	oekd
爺	kslp
廢	mbbe
巖	ullt
铫	owii
邽	hhpf
罟	ujgw
踬	pdgc
笾	gsoc
埝	hrkr
曛	jmgh
絜	dmos
箅	gvlj
貼	julv
楦	aiff
岀	uuss
锳	osco
芘	snnb
绋	kbka
籼	qusm
濉	njeh
鬥	du
厭	vjwh
際	pwjs
顆	javj
炱	nlih
沄	nina
檞	axsp
茆	skmo
舡	upgo
聱	hwtl
钍	ohtj
鹁	gxkm
俠	eorr
谂	drkr
鬧	dauj
硭	vstw
饩	xgqs
菹	snjq
馇	xajf
烆	icic
褰	iskg
搶	frkl
矅	jvve
唪	loak
轟	dddc
蘭	sdaq
栝	alsu
駐	wkjw
纩	kmgj
鎌	tqbk
趑	hixq
楊	ajfc
霧	ckgs
鳊	xhce
昰	jfpi
円	cjvk
掎	foal
鲳	xjjr
莨	skgg
屦	bcqc
緒	ohjr
謂	bvwy
軟	dxqc
玙	jhfi
詭	bxva
滾	nakg
撲	fiqo
棻	skma
膚	uvwy
揺	funw
尨	fcpo
丨	us
濕	njni
莩	sukz
羨	qnxq
規	ojjf
埤	hdgi
螽	tiqq
喚	lxco
齁	qvll
钅	oj
偑	eefr
昪	jnso
靦	sjjm
莸	shfo
醅	pklv
蜩	qwhl
瘗	moqh
畑	ivth
潽	nqij
傉	emhc
郄	senp
埭	hbns
庹	msfk
啶	lifp
憑	iwri
鞲	ssch
枘	acre
廌	mhib
癍	mjtj
硎	vfsm
導	qqoh
髹	ueau
棄	ansf
郤	krlp
梿	axoc
鈺	tjkd
熳	ijub
暲	jkjz
蓮	sdoc
毪	mnpn
庀	mnbg
寧	irua
袓	xjqy
冑	dcir
燄	xdii
淨	nuby
載	gkdc
淿	nduj
悽	rgbc
顒	vvjb
赙	cnhc
湓	nkmu
洎	nqis
氘	gkaq
卣	uwbo
襲	kwug
煉	iawq
牽	anxp
糵	sdkq
紝	omrs
忞	trie
茈	spnb
鮨	vnjr
浍	nrin
栳	ahnb
辌	xaiv
歎	sflx
擇	fuhg
絺	oseu
笱	gwlv
顔	kgcj
姁	cwlv
骒	bjau
阌	tuxb
搌	fbsh
豐	uddq
旡	hwrf
織	okjk
纏	omvh
籐	gwqn
猶	hqpy
廳	mljr
災	lihc
揸	fajf
跽	pori
埵	hmso
摽	fpjs
堺	hvrk
婦	cbxu
撐	fihy
墜	pqth
劼	hlsl
渫	nsau
犇	pppn
證	bbfq
菉	sbns
弇	rsoh
鬍	ujwy
邾	pkpf
僰	acar
婼	csel
槅	aflu
佉	ehna
檒	aaef
蘫	snhu
慮	uvri
擐	fufg
膽	wxvb
縮	oiej
噍	leib
紗	oigp
撙	fqph
氇	mxjr
觋	prrc
堙	hpht
汧	nfso
庫	mdcg
蹻	pmll
測	njmd
謎	bqoc
赸	husz
蜎	qlwy
颥	csvc
鲦	xtau
燚	iiii
鴷	fxmd
蘡	sjjc
挢	fmka
緋	oufs
喲	lowk
寬	isjk
複	xgjt
刂	md
桄	ailw
疳	msir
佇	eiad
喬	mlcl
凅	iwjg
悰	rijs
揑	fdpg
烝	ynfi
沲	ngoe
誤	blfo
紋	otes
瑊	jkfl
繞	ohhl
碕	voal
譔	book
劇	utmd
嚭	hlgl
鞒	smka
踣	pklv
慓	rpjs
烔	icfl
窭	iqcn
慝	hser
凱	ufle
兟	pwpw
燰	iuxt
灑	nfcm
瀰	nbfs
髊	rqpg
韋	bw
瀹	nrce
襞	blkg
矧	jbus
薑	sfvf
執	hqgk
臁	wmqk
紟	orky
獯	hmgh
蒇	skcb
蛘	qqyc
紤	odjs
觍	cskc
眛	jfwm
遺	ljjo
拏	cbfs
僅	esir
扽	fxwk
钋	oubj
苤	sgfi
偳	eusr
艴	bkxo
嗪	lomh
唛	lhtp
榱	aafg
臥	hree
刭	bpmd
穀	hfmh
黪	gnoc
紥	feos
玗	jfhc
澐	ncin
暠	jagr
揾	fjum
廆	mdgg
岎	ukmd
勗	jjsl
遞	duoc
損	fljb
钕	ocnj
氩	glqk
毹	rfwm
攉	fceh
雞	unoe
菑	slvt
骀	bnlv
昖	jkna
缂	ksgj
玘	joiw
慣	regj
垡	ekht
闆	dlll
璝	jljj
紣	orgi
窅	ijmx
綨	ouqs
霨	cbjh
詧	wbyy
怾	rlka
飖	ujes
坰	hclv
鳇	xdjw
锇	ogfk
肟	wfhk
鬷	flct
瑎	jnnd
乇	gxip
嫄	cvdi
禎	jujb
錄	tens
哌	ldgy
鷺	ptld
財	jhgp
囂	llvl
仡	egyi
瘰	mvos
蜣	qqei
籀	gfkv
韂	sxvb
雋	eckh
榮	iixa
憂	vwxt
傭	embw
蕩	snjc
嘗	injr
噁	lfkr
痩	mdbo
鐮	tmqk
牂	dqyq
慾	krlr
讀	bhuj
髠	uejb
辻	goci
砟	vgub
薤	sfxf
鄉	kgkp
瞞	jsfb
蠛	qsuk
孫	kgos
搿	frfs
捲	fqoa
詠	bkns
曐	jjjp
惣	pwcr
寀	iuau
瓿	klrw
誷	bcqt
墮	peph
嵛	urfm
僬	eeib
滠	nlbb
鋪	tnfj
煺	igoc
忭	raub
垌	hcfl
锓	obxb
倓	eiih
峣	uxgl
瘛	mdmr
槔	adog
礦	vmsk
蛲	qxgl
崙	urfc
紦	oobs
暫	ddjr
頵	bglj
壸	hxlq
愰	rjil
劓	qvlm
洤	nrjw
陴	pdgi
騰	wqow
凈	iuby
嘧	liru
俜	edhk
龠	rceh
龐	mkwu
辋	xcqt
獴	hsxt
袪	xhna
鏐	tvvc
咵	lofh
唄	ljbv
鬚	ucvj
蟛	qhcp
汍	nrkd
詟	fgby
蝥	kgtq
儀	eqgk
蓂	sxjk
腠	wofo
稆	mllv
猇	huhq
堋	hwwy
擾	fvwt
轹	xkiv
镘	ojub
襕	xtaq
浽	nucn
咈	lbka
黉	nxsk
鞴	ssgs
詞	byfl
齕	pgyi
殪	fxhq
氾	najs
蝟	qvwy
柃	arkb
燿	ivve
筆	gbak
兇	swwr
篍	gmih
罃	iixj
贠	ncba
騦	wvri
巿	fuji
捯	fdmd
職	lkjk
骱	rrka
餘	krfa
躍	pvve
旛	tggv
蒡	saqt
娡	chri
掙	fuby
穩	mupr
酾	pfcc
跫	pekp
胍	wugy
杩	abmu
恧	srir
垚	hhht
唼	lkcn
忮	rgbo
碼	vwms
壯	dhsq
滲	nnnc
輸	drfm
遲	bnpo
跘	pqak
瓖	jasg
鄠	cfhp
氍	jjem
胲	wthy
輩	udcf
噴	lgsj
凵	wk
檔	aivt
鰸	vhll
烀	igqh
硐	vcfl
灣	nbob
瘮	mnnc
苾	srgp
罞	ukgp
芤	skei
箢	gixa
哳	lfdj
痖	mlqk
攧	fgjj
岺	urkb
嘢	lvky
伱	eriv
踰	prfm
枬	awat
紹	omlv
橦	akvl
諲	bpht
嘯	lbdf
鲡	xfcc
饔	akgk
檎	artn
嚥	lsfi
蚑	qgbo
蠍	qjwx
齊	aqui
峧	uaks
枊	akaj
砑	vhys
狤	hhlv
營	iixl
纻	kifi
戽	higi
囧	wkck
顗	uflj
氡	gtir
晹	jjwc
墚	hnma
甏	hcrw
穸	ixxx
盜	nxum
苘	sclv
钬	oihj
翛	eutv
瑱	jgjk
饣	xs
針	tgij
漎	ncrp
廁	mjmd
鳴	ldnv
唻	lalv
洨	naks
寢	idbb
軀	qhll
獸	llvh
觏	schc
桤	auoi
髎	rvvc
尷	fhgu
枧	acju
毵	nocm
瘼	msjo
麵	atsm
糈	qypw
谞	dypw
镟	otgp
毎	gegi
骺	rdfl
諸	bhjr
鹨	vvrm
丒	mkfi
俫	efqm
嚄	lseb
頉	pvjb
媩	cjwy
凜	iawm
瑯	jkbp
岣	uwlv
铦	olsj
苶	sriv
睱	jbib
楱	aofo
曌	jwip
帯	sfxu
嶲	ueck
酲	pljw
喨	laej
傾	envj
肷	wxqy
峎	uggs
辒	xjum
扞	fngs
蕬	soos
挻	fgpg
積	mhjb
麿	mllv
憤	rgsj
柺	alsl
葇	skga
笢	goxi
熺	ihlv
蛑	qnpn
帳	uucj
煐	isco
塼	hdhc
鲣	xubh
铒	olej
裼	xjwc
黡	vhgh
酎	phcy
湲	nunb
戶	dh
啟	hltp
鑑	thgu
餓	kgfk
懲	cfjr
農	csmc
痲	mira
毳	mmmm
坫	hulv
鈴	trkb
酐	pngy
埜	aaht
潵	nswt
額	itlj
匚	hf
紕	onnb
獎	dwhh
贏	tjbw
胂	wdsy
伹	ejqr
蕡	sgsj
贶	clwr
躜	ppwc
铪	orhj
夬	breo
閻	dxdi
滉	njil
钘	ofso
靣	vwlv
烋	eaib
悶	drim
趼	pfso
鎚	tdoc
舺	uvjo
肅	bddf
構	asch
諾	bsel
摛	ftwn
勔	sslm
袝	xehc
孖	kkzz
渖	nids
泺	nkiv
舴	ugub
玱	jraj
妘	cina
锊	ouhc
擗	fblk
訚	tbym
嵴	uiiw
犭	hq
慉	ranv
涠	nway
晊	jdzr
疬	mvsl
螣	wqoq
繃	ouww
鹇	tamn
碹	viff
粢	ixqm
掃	fbxu
獻	uflh
橋	amll
肭	wcre
璿	juxj
簽	grqz
翹	hhhv
蟪	qdri
苈	svsl
脈	wdgy
眵	jxxx
篂	gjps
珧	jwii
咁	lsir
劂	vqwm
靿	snsl
锼	odub
躧	pfcm
銳	tklw
吲	lbus
嘅	lbnw
脞	wrrh
緜	dugo
钌	okej
撥	fbbe
籃	ghgu
賺	jqbk
嶝	ubfq
斬	ddjc
骕	bbkk
锾	ounb
坭	hbnb
嬸	cigv
縡	oikx
饹	xtlv
項	pvjb
簾	gmqk
嵝	uqcn
瓞	ugof
鎖	tijb
厍	vxjh
鹴	cajm
镈	onhc
編	ohce
陧	pjht
鄜	mpfl
諒	baiv
碲	vaqu
儘	ebfu
茳	snpg
躐	plwb
賭	jhjr
畤	vhhc
鄹	lbep
輝	ilxd
訓	blcy
踡	pqoa
跐	ppnb
牻	pfcp
螗	qmbl
熲	nivj
砹	vssi
鸸	smnr
阼	pgub
綁	odpf
館	kibb
甦	fjsp
縱	ocrp
砘	vxwk
燉	iakt
铽	okri
製	pcmg
摅	furi
埯	hodd
澤	nuhg
捨	frls
茲	snna
貨	enjb
丶	kd
芴	swcp
迺	pocx
飲	kxqs
廑	msir
盩	hqgu
潄	nalt
沷	nebk
歛	rxqq
嫏	ckbp
姤	cdfl
塽	hoss
堳	hbjm
碦	vitl
誦	bbsy
賤	jkkg
惱	rlds
暈	jxdc
嬌	cmll
襬	xunn
鞗	euts
扢	fgyi
憞	rakt
舄	dwib
硇	vdsi
堍	hxlk
酴	prfa
崒	uarg
掯	fpwy
苄	saub
舊	sedi
醵	puts
彎	boob
燘	idte
琯	jibb
叢	iqgb
鬿	ddjg
姪	cdzn
舾	upxo
紖	obus
腘	wwjk
爐	iuvu
皺	wwwb
懶	ralj
虧	uefh
湯	njfc
駛	wlsi
筯	gjsl
浥	nlob
晧	jplv
鼗	wiib
榖	hfau
筅	gpwr
兗	aklw
艚	usjj
夼	olcd
缋	kljc
奓	oxxx
俛	exlw
祄	jrka
蔘	snnc
衪	xoey
臟	wskh
儍	eswt
饸	xrhs
鮻	vnkt
擠	faqi
拤	fjub
拃	fgub
鲚	xtka
迕	ggoc
胨	wxiv
砜	vesi
淠	nvlj
圊	whwy
剉	rrhm
違	bocw
鍵	tbag
烏	dw
矻	vgyi
釿	tdjj
棲	agbc
倉	rkbl
甕	akgr
禍	jrks
撚	fwhi
勞	iixs
輛	dfub
鹓	ixam
阘	tjvv
貎	vdwr
杮	afuj
喪	gllh
哜	ltka
朊	wflw
菪	sivs
钸	oeuj
兲	jkaw
兊	knwr
蒨	sehw
躔	pmvh
凍	iajr
盧	uvum
谿	unol
罣	uhht
惓	rqoa
飾	kguj
橥	hhja
鐾	blkt
滗	ngmm
筘	gflv
箦	ghcb
彌	bfks
腈	whwy
喛	lunb
骎	bbxb
豾	vgfi
暸	joqi
斲	hbkd
扠	fbkd
丷	qk
奌	ulod
蠊	qmqk
埼	hoal
琎	jiko
癋	mfkr
縠	hfos
詛	bjqy
鞞	sdgi
濟	naqi
獞	hkvl
絶	oxob
浬	nvls
奧	dgqo
琝	jjte
仉	eejr
辶	oc
駕	slwm
溝	nsch
暐	jbwr
圏	wqoo
犏	phce
蕺	sllk
爚	irce
镧	otaq
馘	qqkf
亊	hqbj
毌	egim
漥	nihh
巻	qooi
齉	qvlg
骦	bcaj
飐	esul
觽	xsuc
籓	gngv
瀟	nsbf
旂	tgdj
扆	hagy
贊	pwpj
綑	owau
垲	huoi
瘥	mqpg
罈	jpjz
鋒	ttdf
徑	cflp
坶	hemt
頸	flpj
獲	hseb
獵	hlwb
糇	qebj
绠	kfjs
莶	srfn
髟	ub
姎	ccod
踼	pjfc
臺	hlxd
褟	xjvv
頹	mwvj
滘	nxkl
坌	kmht
侶	eldx
暢	djfc
洩	ndgp
潛	nhwj
挼	fucn
監	hgum
玧	jnwr
欻	iixq
暼	qukj
梱	awau
忄	rx
礓	vfvf
钫	otfj
佢	ehbo
堉	hanw
廻	wlgy
蹯	pgqv
両	fcus
轘	dufg
嫰	calx
潤	ndjw
厾	yhna
岽	uxiv
揞	fkjr
羰	quei
悅	rklw
奪	oehc
臘	wlwb
縫	otdo
辭	ubck
閟	drgp
肀	bj
蹽	poqi
鸲	wlmn
昻	jpaj
璛	jbdf
閤	drhm
趐	hvvx
裵	augy
缷	jajf
罠	uoxi
铋	orgp
淓	nstf
塙	hagt
廙	mvsk
昐	jkmd
桖	agum
梶	abmm
槨	aakp
禥	juht
縳	odhc
蚃	kgqc
飺	pnks
鼯	dbfl
濤	nhyh
垞	higx
藝	shkn
繫	dweo
垟	hqyt
剠	aimd
恥	lrie
衄	gubc
齋	aquj
簷	gxvb
啣	lgfa
潰	nljj
勳	mgsl
澉	nylt
肼	wika
胬	cbcr
傺	ewjs
厔	vdzh
陞	pgsh
锫	oklv
倿	ekcn
匊	wqmb
酞	pokd
廂	majm
葰	sent
躹	qwqm
鹯	awlm
鑄	thyh
炧	igoe
窮	iqbg
聰	ldtr
螞	qwmc
闖	dwmm
珵	jljw
誌	bhri
櫆	adig
咶	llsv
赆	cbki
榍	abiw
楶	ixla
枨	ancu
鹛	bjmn
鹋	svmn
窀	ixwk
棁	aqlw
圝	wboo
窆	igoz
捃	fbgl
桊	qoau
蕹	sake
瓚	jpwj
粿	qjau
鍾	tmvl
讠	dy
鎯	tkbp
鷹	meed
燜	idri
葙	sajm
轒	dgsj
晩	jxjw
欗	asdq
璆	jvvc
砮	cbvs
罨	uodd
礌	vcvt
葢	soku
騩	wdgm
鲃	xobv
欄	adaq
鎧	tufq
轪	xodj
銙	tofh
賴	alxj
餜	kjau
蒴	sqww
蒟	skwl
倫	erfc
蟭	qeib
療	moqi
訊	bygi
恓	rpxx
誡	bkso
渰	nrso
蟟	qoqi
俬	emna
跞	pkiv
酤	pjgy
锬	oiih
蜾	qjau
锿	oagy
鲻	xlvt
劒	rmkd
媭	cvcc
蟜	qmll
恝	dmri
棆	arfc
樫	ahbh
濆	ngsj
睒	jiih
篠	geua
罰	ubmd
罽	uvim
懸	jigr
蠻	booq
牴	pkxk
鷫	bddd
訸	bmhy
闊	dnls
锪	owcr
祏	jvss
璱	jjjg
熇	iagh
懞	rsxt
丬	qq
巯	bpaw
謹	bsir
厐	vfgp
钷	ohlv
绗	kcic
皘	dhwy
閑	daum
眢	xajm
勵	vsvs
虓	ruhj
阯	ppif
獅	hdfu
韁	sfvf
傘	rrrg
鹍	jnnm
鉵	tqcj
覚	nxjj
饳	xwwk
缊	kjum
懗	rhkk
廟	mgjw
冱	ifem
憝	aktr
掭	ffok
貫	egjb
蛸	qiwy
驵	bjqm
糼	osls
噀	look
偓	ebdz
歩	pigp
浰	nmmd
滍	nwfq
稙	mgjq
糢	qsjo
礙	vnjp
註	bkjw
詳	bqyy
飢	kejs
鳸	hdnh
齧	dmpc
馉	xrgs
聳	crrl
鄤	jubp
讇	bdxd
衁	tgum
眍	jhsi
糧	qjfv
崚	uhkt
撿	frqs
庳	mdgi
瘅	mqjg
羧	qnkt
萆	sdgi
蔵	skhe
铞	oluj
倅	earg
蔭	sprn
実	iopb
钽	ojfi
芣	sguo
杻	abcu
瑆	jjps
瀬	nalj
柊	atir
掹	fkum
甓	blkr
綿	oduj
爇	shki
瑒	jjfc
璮	jawf
眽	jdgy
祹	jwjf
繻	ocsr
芼	smmo
腄	wmso
汭	ncre
蕅	snvy
趯	hvve
醜	pdgy
渾	nxdc
縴	oanp
纍	vvvo
渄	nufs
罝	ujqw
歺	uxxb
搋	fduh
蓥	sxtj
锖	ohwy
阝	pf
阽	pulv
鲒	xhlv
鹱	mseb
刬	fkmd
緻	odtp
棨	htau
瘭	mpjs
嘠	lvwk
噏	lrvv
墳	hgsj
貪	rkyj
捥	fixa
挶	fbyl
憟	rpqm
帱	udhc
姖	chbo
嶒	uqjj
峯	utdf
寯	ieck
泐	npsl
鎙	tqww
衎	cnic
蚇	qbkd
祔	jehc
矦	xvji
浐	nkgp
瘵	mwjs
箨	gfba
洑	nehq
荬	syio
晅	jfjf
蝻	qgcg
垤	hdzt
扥	fgxi
劙	etqm
悺	ribb
尅	jwhc
蠅	qgmc
峇	urhs
櫃	ahlj
兌	klwr
賜	jjwc
嚕	lvjr
膩	wkij
魯	vjrv
脅	sssw
汙	nfhc
癲	mgjj
眊	jmmm
勸	slls
朅	hnje
曵	dgkd
瞝	jtwn
晣	jfdj
胩	wjub
窺	iojj
騷	wbkq
冊	ce
廍	mklp
蓰	scpp
谫	dqwm
迮	guoc
钔	otmj
倞	eaiv
禘	jaqu
絪	owod
挾	forr
嬰	jjcn
鹖	jwrm
騊	wwjf
痺	mdgi
運	xdoc
靬	sngg
揹	fqnw
檢	arqu
訶	balv
鎮	tgjk
嬝	cdag
偲	evri
臢	wpwj
訏	bfhc
逬	gngo
苧	siad
罍	vvvj
妶	cana
垯	hooc
踺	pbag
嗢	ljum
凥	bejs
卨	urkb
纟	kj
嚜	lght
峠	ujjx
暪	jsfb
潅	ngfe
犮	ebkd
碃	vhwy
簃	gmxx
羮	qifo
衒	cani
誧	bnfy
諡	bkhu
耖	dkig
溚	nsrh
椠	xdau
夂	tp
嗚	ldwv
鶉	akdn
濺	njkk
跼	pbyl
唊	lorr
炤	imlv
齡	prkb
驅	whll
飽	kwos
賀	sljb
鵝	gfkd
窩	irkx
瑪	jwmw
穫	mseb
鳼	tdne
雸	csir
瑩	iixk
璷	jntt
襜	xxvb
葎	scba
脽	wehy
洐	ncic
朘	wnkt
挓	figx
廇	mkvt
嫕	chjr
刧	hnmd
亸	akqg
廒	mhwt
宀	ib
詢	bwjr
殼	hfej
脣	mwyc
訪	btfy
譜	bqij
絃	oana
竄	idbs
豎	hbfq
褧	liag
嘍	llgc
娒	cgem
錶	thgy
鬘	ujub
鴞	lhdn
併	eqso
啲	ldwk
鰭	vhnj
繩	ogms
攤	fsfe
儲	ebhj
築	gpea
霊	cflq
誅	bpka
褕	xrfm
醣	pmbl
餬	kjwy
齒	pc
癢	mqog
閰	ddim
睪	uhqg
駼	wrfa
鹙	mimn
赪	hkkc
氪	gjwr
侘	eigx
亹	adcj
赇	cfnk
衤	xy
聍	liad
泶	nxns
藫	snpj
榀	alll
攵	tp
氙	gusq
屻	umkd
渏	noal
蓳	ssir
耞	dksl
珜	jqyw
軒	dngc
吜	lbcv
涁	nacp
惔	riih
頁	vjbs
彆	qukb
癩	malj
慶	myrt
暱	jhsl
辯	kbkx
減	nkfl
燙	njfi
龜	ggmp
貞	ujbb
閱	dklw
寛	isjj
撘	fgrh
皽	awlb
珦	jdxw
蛁	qmlv
裀	xwod
褍	xusr
証	bfpi
踆	pnkt
遆	aqxo
籙	gtbn
骙	bbfo
鯹	vjps
窊	iugx
磡	vues
盷	jwir
袥	xvsy
螦	qhos
溍	nlqj
渋	npii
斝	llxg
擓	fhne
丿	gp
埏	hgpg
牿	pplv
猹	hajf
篚	ghuf
噽	hlgf
嚒	lmna
馳	woem
頗	bvjb
納	ocre
攝	flll
癎	mdjr
鬱	ajac
糾	owjs
茻	wwww
褆	xjfp
蹡	pdwh
珓	jaks
玚	jycp
燋	ieib
焠	iarg
鱗	vqxa
憍	rmll
摟	flgc
爍	idna
锎	otfs
哴	lkgg
楓	aefu
卆	rgij
镓	oits
舣	uksi
評	bnqk
蹐	piiw
筊	gaks
黨	ighs
荊	sfsm
祿	jens
枒	ahyu
縛	onhc
悾	ripg
顓	usvj
蓆	smsu
裈	xxxj
賦	jfkp
偊	egqc
蝕	kqcs
栻	akpg
揝	ftuj
溼	nfnh
巈	uswq
覤	ujjh
蹅	pajf
崈	ijus
鑨	tkwu
鼌	jfld
峊	dusd
妸	calv
樋	abso
皕	vjvj
鼷	dbuo
仫	egna
倶	ejfk
痄	mgub
謔	bubj
礤	vswj
矝	kgrb
疍	ypjf
趎	hpka
饒	khhl
繤	sjoo
纁	omgh
砫	vkjw
燻	imgh
漈	nwjs
鞃	sbna
菓	sjau
艷	uddo
礟	vwss
怳	rlwr
頑	flvj
愑	rbss
扙	fekd
姞	chlv
唡	lfcr
咇	lrgp
抃	faub
掻	fbqc
搵	fwru
敚	qlwt
朏	wwwk
週	whlo
杙	akiu
偡	euei
訂	bady
鳢	xcsq
鳙	xmbw
榼	ahnu
螬	qsjj
攴	ubob
毘	vnnb
顠	pjvj
競	klww
濪	nhwo
焮	idxq
頠	xvaj
鏮	tmbn
鐲	tuwq
颭	eulv
馃	xjau
巔	ugjj
藚	shuj
鷉	dudn
鬽	dcpg
镮	oufg
迍	xwoc
蝀	qajr
蒳	socr
蓕	sahh
麀	mnbl
菻	saau
嶽	uhbh
菴	sodd
艸	wwcc
膄	wdub
鸊	blkd
尪	fjwo
麹	htwq
羵	qgsj
闢	dblk
鍋	trkj
頰	orrj
鈔	tigp
壇	hawf
噓	luwf
塗	nrfh
嵙	umig
諷	befy
億	ekjr
撢	fpjz
頻	pivj
稅	mklw
聼	ylgr
瞵	jqxa
洚	ntak
儼	ellt
铑	ohnb
镦	oakt
匄	wtwb
帨	uqlw
钇	oyij
螵	qpjs
償	eijb
葜	sdmo
耩	dksh
愝	rhjc
懮	rvwt
拠	ftej
綻	oifp
撖	fylt
斅	dssb
爊	imib
磌	vgjk
硁	vbpg
眞	njek
畯	vnkt
櫈	abfe
犺	haej
瀍	nmvh
濊	npki
洸	nilw
蹱	pkvl
鈇	tofj
媧	crkn
芧	skyo
筭	gjso
圧	vhth
呂	ldxv
鉷	tska
竢	knji
雛	wwwe
購	jsch
瞜	jlgc
璾	jaqi
璪	jlla
熌	idre
籤	grrf
飼	kyfl
鞥	srso
歘	iiix
杇	afhk
捊	fukz
挷	fdpf
囷	wmhw
娖	cpzn
奷	cmqn
鏈	tdoc
澭	nake
媜	cujb
魟	vpgv
钐	ocpj
汎	nekd
嘖	lhjb
偵	eujb
曬	jfcm
誇	bofh
鸺	eamn
矞	kgcl
廴	gy
楗	abag
澀	nmkp
荳	sflq
凖	iegi
狹	horr
贳	scbi
闔	dhnu
唗	lhzv
匯	hneh
镎	orfs
蔔	swfv
誕	bgpg
鋼	tcqu
醰	ppjz
瘖	mkjr
囍	hlhl
盦	rkyu
镋	oiwr
轎	dmll
曪	juoe
辀	xuoj
晼	jixa
畬	rfav
甃	mirw
禝	jvkt
灜	ntjb
翾	uflv
濄	nroc
漼	nueh
涴	nixa
橝	apjz
朣	wkvl
曚	jsxt
挐	clfs
誐	bgfk
壄	akgh
囓	ldmp
嚿	lsed
吿	plvn
僎	eook
骣	bbkk
醭	piqo
胠	whna
芵	sbre
萳	sgcg
蟸	tqqc
鱽	xmdv
砢	valv
邁	svoc
絡	otlv
輔	dnfc
審	igqv
阨	pvaj
謙	bqbk
貝	jb
禖	jsia
郵	mspf
閣	dtlv
擬	fnjp
疊	vvvj
腸	wjfc
竊	igqn
潑	nbbe
袞	aklg
偽	ekgw
筍	gwjr
蔣	sdwh
侷	ebyl
驕	wmll
込	bocu
擱	fdtl
鄘	mbwp
裯	xwhl
蛦	qobg
镃	oqnn
菼	siih
舖	rlnf
倻	elpf
蘇	svmh
絔	ovjr
軌	drjc
镴	olwb
鴦	codn
雝	lloe
鹔	bkkm
鹢	qkum
麕	mwmh
棟	aajr
耑	usrs
碨	vvhf
篛	gbii
摎	fvvc
掞	fiih
戦	njgk
搯	fudi
嶋	udns
宆	ibgb
囯	wjww
哋	lhoe
劐	sebm
儛	egsa
嚆	lsag
犋	pjka
腽	wjum
膣	widz
蔹	srft
鳓	xssl
揙	fhce
昞	jfcr
窾	ihjx
栒	awjr
鹎	dgmn
矌	jmsk
眮	jcfl
癨	mceh
狜	hjgq
瀼	nasg
濩	nseb
泙	nnqk
泆	ngof
泂	nclv
槻	aojj
賊	jkez
顛	gjkj
筳	gmgy
擡	fhld
耠	dkrh
敧	oalb
搗	fdus
滯	nsfu
彙	exja
隠	pubr
績	ohjb
喤	ldjw
吚	lbgp
勅	alsl
萜	suul
鄴	iqkp
銷	tiwy
巘	uufh
朧	wkwu
鑰	trce
鐚	tfkr
靇	ckwu
噷	lkjx
闋	dbfo
鸴	nxmn
髈	raqt
饀	kudi
艙	urkl
餗	kalv
銅	tcfl
洶	nwsw
鞶	uesg
滄	nrkl
賢	hbjb
噇	lkvl
瞍	jdub
婞	chqg
浿	njbs
眘	oqjm
澴	nufg
脥	worr
誔	bmgy
尓	givz
駡	llwm
譚	bpjz
軏	dlwc
穌	vmhv
譽	dhjb
邉	qilo
経	obht
朒	wcrr
怮	rnsl
蔥	sdtr
憯	rhwj
攽	kmtp
抷	fgfi
舭	unnb
葔	sebj
鐏	tqph
訣	bbre
踧	pjib
啞	lfka
遯	wtoc
躭	qxwr
裩	xjnn
陜	porr
鈚	tnnb
蒐	sdgo
稂	mkgg
丗	sfis
侫	etcn
刄	mkdd
釦	tlvj
慍	rwru
債	ehjb
窪	inhh
瘕	mbib
飊	iiie
钆	oeij
魋	dehg
馎	xnhc
鄭	qpop
饦	xgxi
餂	klss
麥	atpl
噐	llpl
脎	wsau
偁	euch
渦	nrks
轅	dhlg
斃	qukn
曠	jmsk
灘	nsfe
宧	iheb
厖	vfcp
纖	orrf
嗛	lqbk
抜	febo
摰	hkhf
撴	fakt
覷	uijj
朓	wwii
鹹	ukfl
橿	afvf
淂	njfh
羃	usju
靨	vjws
睖	jhkt
鰣	vjhh
杄	amqu
煵	igcg
漷	nakp
盻	jkhk
柈	aqak
漲	nbuc
蒻	sbii
謊	bstw
玆	anan
楛	asjg
樉	aoss
殽	sewe
沘	nnnb
渟	naad
滃	nknv
瀞	nhwy
潝	nrvv
驟	wlbi
皏	dqso
癱	msfe
暎	jsco
綱	ocqu
棬	aqoa
韻	kjlj
駭	wthm
晸	jfpt
稌	mrfa
艱	sflg
懇	vgri
豈	uflq
祙	jfws
粞	qpxm
耵	lade
膦	wqxa
膪	waql
镅	objm
侼	egxk
禿	mwrh
剬	usmd
効	akss
咉	lcod
僇	evvc
娭	cnji
嬿	csfi
屭	bjjj
廞	mtxq
徴	cjwc
扺	fkxi
掫	flbo
奡	vjok
螢	iixq
緼	ojum
薆	suxt
壽	hyph
鬹	ojfu
靪	sadg
雚	slle
嗶	ljsa
矓	jkwu
隢	phhl
糞	qvsk
舑	lcht
噠	lhqo
縢	wqoo
胐	wwwk
巒	boou
逷	jwco
砵	vafi
瑑	jets
珌	jrgp
縣	jigo
煴	ijum
栆	glri
洢	nebg
祅	jmys
柸	agfi
柷	alwr
擴	fmsk
暤	jdog
擭	fseb
摗	falx
碻	vags
漁	nvvs
遫	alto
嬤	cmna
襯	xkaj
鸧	ramn
黦	gixa
鮗	vtir
鮀	vinb
騒	wbqc
獰	hira
邅	awlo
疪	mnnb
頀	kjsb
軿	dqso
寵	ikwu
铚	odzj
筦	gifl
迶	ewoc
昫	jwlv
慒	rsjj
疰	mkjw
虀	saqf
铟	owod
吳	leod
醑	pypw
缏	kefs
癃	mptp
蔀	sklp
蠙	qifj
巜	lc
嚨	lkwu
酺	pnfy
燦	iuxq
憊	esgr
魘	vjwd
虇	sbse
篴	gtoc
嗆	lrkl
躘	pkwu
鈕	tbcj
宭	ibgl
囮	wenb
咾	lhnb
呴	lwlv
侁	epwr
坉	hxwk
攔	fdaq
篤	gwmz
贌	jiqo
袑	xmlv
醃	podd
変	ttpy
寃	ixlk
恗	rofh
憵	blkr
扜	ffhc
敊	jiub
瓏	jkwu
抯	fjqs
挦	fbhc
搢	flqj
唌	lgpg
喯	logs
遜	kgoo
咷	lwii
兛	jwmq
儵	eutg
僱	eheh
倷	eojs
倕	emso
耢	dkss
漤	naac
啓	htlv
昩	jfmr
屜	bcsi
铌	obnb
蜋	qkgg
餅	kqso
釀	pasg
豝	tobs
臞	wjje
嫵	cgsi
嚧	luvu
趙	hiwy
絨	okez
踘	pwqm
鈡	tlus
鏰	tuww
鑯	trrf
靑	hcjv
鞎	sggg
韮	sufi
鬒	ugjk
鬴	flcn
鬺	flcc
鰡	vkvt
槤	adoc
鹵	ul
剷	kgpm
鎔	tirl
瑤	jwjf
屆	bhwk
褵	xtwn
鏢	tpjs
藟	svvv
葊	srso
暕	jawq
杬	aflw
棌	auau
辮	kokx
檓	adpe
毣	vvmm
狽	hjbq
湳	ngcg
涶	nmso
璹	jhyh
瓃	jvvv
瓫	kmrw
皀	dnbb
硚	vmka
磝	vhwt
剝	enmd
竜	kddl
蠟	qlwb
嘩	lsns
筸	gjng
繐	odri
耰	dkvt
嘨	lbqk
賠	jklv
宊	ihqb
謠	bwjf
挰	fljw
揳	fdmo
擩	fcsr
旿	jggi
晛	jjjr
曽	qvjr
栢	avjr
栴	agwa
欵	njxq
汸	ntfs
涭	nuxb
渧	naqu
滛	nujf
焄	bgli
狢	htlv
玼	jpnb
畷	vbbb
眫	jqak
睄	jiwy
睮	jrfm
揌	fvri
慽	rkji
礑	vivt
愖	ruei
臍	waqi
葦	sbwo
蹺	phhl
頷	rkyj
羶	qawf
籟	galj
駁	wssi
搆	fsch
衆	guei
碥	vhce
蓣	skvc
镩	oilu
乢	ueis
劄	grmd
呉	lefk
坵	hdfi
妧	cflw
岕	urka
嵎	uvys
矈	jdit
筩	gbsy
鰏	vflv
髃	rvyg
鰉	vdjw
箙	gwab
鲙	xrin
鴳	icdn
鴸	pkdn
麑	mdwr
儈	erfj
殢	fxsu
犖	iixp
莖	sflp
燼	ibfu
鰲	hwtv
觝	xskk
勻	wirb
簑	gafg
鬵	hwhu
蘿	suoe
験	wrre
蔴	smao
簠	gnum
簮	gooj
籥	grce
绖	kdzj
脤	wmcy
茓	sixo
霙	csco
莾	sogs
緞	oele
藠	sddd
襛	xcsm
觱	kfls
豤	tggs
鉄	tgof
錞	takz
籠	gkwu
釘	tadj
嶺	urkj
譯	buhg
枴	almd
猙	huby
瑋	jbww
豊	csfq
敘	rfat
屝	bufs
渼	nqod
澥	nxsp
喓	lpcn
嗗	lrgv
嗮	ljpx
崄	urfn
嵖	uajf
巵	dfob
庼	mnvc
悢	rkgg
惙	rbbb
憇	lsir
扐	fsls
捁	fplv
旳	jwkd
棐	uauf
榢	aits
氺	ns
泹	njfi
唝	lpcb
咑	lfad
吪	lenb
皁	dgib
斂	rtpq
譟	blla
鉤	twlv
弔	busg
黴	cfgh
縷	olgc
獃	uflh
仂	eslr
凃	irfa
怊	rmlv
耥	dkis
菝	sfek
蝽	qojr
铼	ofqm
镄	obkc
儯	eqow
碩	vvjb
愜	rhor
濙	niii
濁	nuwq
麯	atcs
鸁	tdnw
骻	rofh
鞰	sjum
鞆	sfcr
鈌	tbre
鄚	sjop
踖	psjr
賨	ijjb
豗	ltsw
癕	make
錘	tmso
誙	bflp
熾	ikjk
饋	kljj
稟	awlm
鄰	qxap
袗	xrcp
蝂	qddb
蜺	qdwr
莙	sbgl
苽	sugo
舲	urkb
肈	hkba
纋	ovwt
笹	gsiz
礜	dhjv
磞	vuww
淪	nrfc
鴉	hdny
癮	mpur
磚	vdhc
頌	knvj
蠶	hwhq
頒	kmvj
淵	nddf
楢	aqpy
訕	busy
犧	pqmk
蚿	qana
徧	chce
袵	xemr
郱	qspf
踨	prrp
诐	dbpy
詑	binb
嬻	chuj
寑	iebb
飆	hhhe
儸	euoe
貧	kmjb
喣	lwli
尃	nhcf
崿	ullh
頔	dvjb
慆	rudi
拑	fsir
鑾	boot
蠧	hxvq
蟁	oxqq
堌	hwjg
攢	fpwj
缐	kdns
鞷	flcs
飗	eskv
蘊	sowu
鰗	vjwy
鰧	wqov
鲌	xdbv
鲐	xnlv
鵹	mwgd
侓	ebak
酏	poey
紈	orkd
脲	wbns
缲	klla
霅	cbyy
劖	xlnm
匤	hjkd
唅	lrkl
癀	msdk
铏	ofsm
贈	jqjj
飔	esvr
箠	gmso
栣	aemr
牁	dalv
焅	iplv
窋	iwwk
瓛	jufh
澒	npvj
滪	nkvc
盝	bnum
渻	nigj
掤	fwwy
挕	fles
瑳	jqpg
憚	rllg
洊	neuk
姦	cccn
暋	oxtj
搫	uefs
硿	vipg
嵐	uefs
産	kgps
輟	dbbb
苳	stir
牣	pmkd
拺	fack
晈	jaks
灕	ntwe
壂	bskh
濫	nhgu
慥	rplo
慇	dbyr
痀	mwlv
羈	uswm
槓	apjb
竅	idtt
穢	mpki
鎲	tiwr
輗	ddwr
逌	uwbo
鳀	xjfp
禪	jllg
鸑	hbhd
齆	qvlo
釁	dcfm
譎	bkgl
墊	hqgh
韓	gjbw
礎	vaap
澆	nhhl
漿	dwhn
鱓	vllg
陿	phor
陏	pewy
铇	owos
鈎	twna
綴	obbb
醄	pwjf
邭	wlpf
惛	rkxj
蹠	pmsi
墦	hgqv
挜	flqk
済	ntki
煕	hoib
煶	ijfp
熛	ipjs
牋	dkkg
皦	ddtt
棪	aiih
睍	jjjm
睸	jbjm
矰	jqjj
禋	jpht
柮	awwk
秗	mmyh
恘	reau
稧	mdmo
妬	cvsn
枙	avaj
涏	nmgy
榦	gjra
楩	aefs
綵	ouau
娀	ckez
嚗	ljsn
樁	aodi
盃	gumu
婗	cdwr
媟	csau
嬬	ccsr
宬	ikyi
釣	twkd
啅	lujz
脹	wucy
嶬	uqgk
巂	uecl
廕	mprn
痾	mpal
氈	awlm
摥	fgjc
嚚	llhl
穉	mbnp
蜼	qehc
亖	iirr
偪	eflv
兪	bfwl
鳘	getx
凘	iudj
勍	aisl
吥	lguv
彥	tvcp
赨	hkkq
讙	bsle
褯	xmsu
樸	aiqo
蠋	quwq
袿	xhht
臒	wseb
脧	wnkt
傜	eujf
戸	hh
懽	rsle
簉	gplo
冂	ck
憗	atri
粧	qmht
翯	vvag
戤	gbuk
肐	wgyi
鼢	dbkm
魖	duie
絙	ofjf
曮	jllt
綉	omgn
荖	shnb
繄	hjeo
沍	nfem
橕	aihy
欬	txqh
麄	kmml
毦	lmme
炟	ijfi
滳	naql
犂	mwgp
燐	iqxa
滶	nhwt
漧	ngjy
煆	ibib
煹	isch
酙	pigi
缞	kafg
獏	hsjo
発	biwr
眝	jiad
瞫	jpjz
硰	nigv
碏	vsjr
碔	vfkp
碞	lllv
磈	vdgs
磳	vqjj
祘	jjss
詐	bgub
臲	qaxa
醁	pbns
膆	whos
憀	rvvc
録	tbns
醨	ptwn
玽	jwlv
璫	jivt
髥	ucir
驀	sjow
罥	ulwy
骹	raks
飋	ejjg
雰	ckmd
闍	dhjr
脰	wflq
锧	odgc
贗	vedj
鐻	tuts
鐄	tsdk
覩	hjjj
誱	bfbp
軃	qllg
轓	dgqv
酂	pwpp
袐	xrgp
虩	ijiu
挌	ftlv
唚	lbxb
慬	rsir
腫	wmvl
稊	mqbg
穂	mfdr
窎	imnx
礞	vsxt
恇	rhjw
幋	ueuj
巇	uufk
屇	bvts
嫃	cgjk
姵	cefu
増	hqvj
蝦	qbib
塆	htbg
鍛	tele
磉	vbba
疢	mihb
綢	owhl
壺	hxka
茇	sebk
嗏	lsra
勷	asgs
迒	aeoc
梟	daun
悵	rucx
囑	lbnq
冦	xflb
膠	wvvc
兓	hwhw
趨	hwww
緲	ojig
粋	qrgi
侽	evsl
銘	txlv
菿	sdmd
膙	wblq
狑	hrkb
葅	srrj
蒒	sdfu
蔾	smwa
熣	iueh
毷	cijm
淊	nxdi
淛	npcm
薿	snjp
哱	lgxk
绤	kkrl
筴	gorr
緤	osau
糥	qssr
姱	cofh
姫	chen
壖	hcsr
攪	fdsj
齷	pbdz
絞	oaks
堷	hkjr
噉	lylt
喴	lkfc
唶	lsjr
琱	jwhl
瑮	jpau
歯	pqwk
癴	mbof
睆	jifl
睲	jjps
絆	oqak
珫	janw
猨	hunb
秅	mgxi
秏	mmmh
贖	jhuj
篨	gpra
哖	lgak
覼	fkuj
哃	lcfl
澽	nuts
飸	lhks
鞧	sqpy
詨	baks
佽	eixq
誸	bban
趫	hmll
焟	isjr
蹍	pbsh
焇	iiwy
烓	ihht
蹧	psjj
呠	lafi
郈	dflp
鉏	tjqj
鋋	tgpg
閦	drrr
廾	so
闬	tngm
刪	cmde
镨	oqij
菥	sadj
耔	dkkz
駹	wfcp
骃	bwod
魀	drka
瑣	jijb
厠	vjmd
兎	glwk
儭	ekaj
鵬	wwdn
蘘	sasg
袠	agog
褾	xpjs
覙	xijj
牮	ekpn
訑	boey
緬	osms
訳	bbkd
騃	wnji
蟳	qbph
齬	pfbl
齪	ppzc
鷬	sdkd
溁	nsxa
滈	nags
鵚	medn
漻	nvvc
嫞	cmbw
鯛	vwhl
轍	dant
欶	alxq
様	aqns
椀	aixa
颼	edub
擿	faqo
擵	fmfs
盞	kkum
繆	ovvc
僕	eiqo
曆	vmmj
釵	tbkd
攙	fxlk
醬	dwhp
憙	hlri
愽	rnhc
緝	olle
徶	cqut
衕	ccfi
縈	iixo
諧	bnnd
錐	tehj
蕭	sbdf
欉	aiqb
崗	ucqu
嘔	lhll
繚	ooqi
帩	uiwy
嵁	uuei
嶓	ugqv
帢	urhj
蓏	suug
衠	cgji
阛	tufg
蟢	qhlv
螲	qidz
迵	cflo
靰	slwg
鞡	sfkl
蝲	qalm
蕓	scin
臓	wskh
苙	sklo
裇	xgum
臑	wcsr
飂	evvc
婙	cxby
羒	qkmd
綯	owjf
鄗	apfg
鄫	qjqp
糬	quhj
粄	qdbo
酕	pmmy
簰	gddg
镵	oxlk
锽	odjw
軦	dlwr
銊	tkfi
嬢	cakg
跓	pkjw
錧	tibb
寖	inbb
帲	ugnn
踚	prfc
尫	ljww
貙	vhll
嫀	comh
鋙	tfbl
鉆	tulv
釬	tngj
抅	fwna
峵	uien
鍠	tdjw
貒	vusr
譪	bsje
踶	pjfp
諕	buhy
諔	bjib
褅	xaqu
巗	ullt
筞	giau
勀	jwsl
秖	mkxi
禂	jwhl
洴	nqso
泝	ndkd
気	gsiq
歠	bbbx
檡	auhg
楏	aohh
桲	agxk
枲	nlau
杦	axkd
鹐	xdmn
夋	nktp
讞	bufh
脒	wqmy
乗	msoh
鹮	uflm
俢	etcp
圞	wboa
吰	lena
卲	mlaj
僄	epjs
僊	epoo
兯	qajk
冓	scht
勈	bssl
処	tejp
浟	neut
斁	uhqt
涰	nbbb
攅	fooj
碝	vsod
矔	jsle
矋	jvsv
矊	jodu
瘝	muns
拝	ffdf
揵	fbag
髴	ubka
瓌	jaug
剚	hlbm
璉	jdoc
鯾	vefs
涷	najr
琩	jjjr
牚	ihys
牐	dmdi
爧	iclr
煼	iwww
烕	kfih
澨	ngpr
潏	nkgl
湝	nnnd
鲗	xcmd
鷿	blkd
姶	crhn
泩	npss
廬	muvu
氳	gwru
誼	bijq
篋	ghor
娛	cleo
塹	ddht
籬	gtwe
曇	jcin
妝	dcnq
窯	iqib
潟	ndwi
繽	oifj
颯	kefl
鈍	txwk
鴨	vdnj
欽	txqj
廚	mhhc
嘮	liis
痠	mnkt
鐺	tivt
峽	uorr
髏	rlgc
摯	hqgf
鯊	nigv
襈	xook
袮	xgiv
赒	cwhl
豖	tkds
訧	bfoy
詌	bsir
襩	xhuj
裛	alog
裭	xuhy
覊	pswm
覀	px
褭	awgy
蟦	qgsj
蠈	jkeq
痃	mana
蝜	qxjb
秬	mhbo
琭	jbns
瑺	jiuj
璄	jkjw
瓓	jdaq
癚	mxvb
眤	jbnb
睌	jxlw
瞹	juxt
礧	vvvv
穟	mqto
綺	ooal
繖	oswt
翣	vvkc
荅	srho
菂	sdwk
蒑	sdbe
蓚	seuc
躩	pjjb
蕰	snju
蘪	smqm
趷	pgyi
鉥	takd
軫	drcp
綣	oqoa
刲	hhmd
騑	wufm
騨	wnjg
骴	rpnb
髢	uoeb
髽	urrh
鬅	uwwy
鳷	gbdn
鵩	wabd
鷃	jicd
鷟	tgjd
鸂	nund
鼑	ujdd
龒	kwuj
缽	jafi
鏟	tkgp
姍	ccen
枓	aigi
鞦	smih
啗	lxdi
齣	pwlv
辢	alkx
曖	juxt
迻	xxoc
遈	jfpo
鏗	thbh
邲	rgpf
郪	gbcp
醖	pjum
珹	jkyi
銹	tmgn
鐧	tdjr
钖	oycp
闉	dpht
隄	pjfp
鞓	sljw
頞	icvj
颋	mgvc
餔	knfs
饾	xflq
駉	wclv
駮	waks
琙	jklf
盫	rpum
玃	hjjb
啑	lfbp
喫	ldmo
吙	lihv
鶴	xedn
躪	psde
呪	llwr
呺	llhk
哊	lewy
駝	winb
啈	lhqg
熥	ibso
孋	cfcm
嗱	lrfs
噑	ldig
薦	smhi
矚	jbnq
噭	ldtt
囖	lgue
埈	hnkt
妰	cgub
娵	clbo
厪	vsir
剕	umdf
兠	dqnw
儾	eglg
疒	mb
喹	lohh
冖	xm
稃	mukz
筻	gfjs
醌	pjnn
镥	oxjr
鲰	xlbo
輯	dlle
鼽	qvlr
遷	pooo
淺	nkkg
俁	eleo
鴻	npdn
俍	ekgg
倂	egnn
傌	ewmr
劑	aqum
貢	pjbg
嬾	calj
喭	lkgc
宍	iaka
橸	ajjj
挵	fjso
捒	falv
撝	fugw
敠	bbbb
斶	duwq
昬	oxjr
櫜	glxa
嵂	ucba
恡	rsen
榾	argu
暏	jhjr
曎	juhg
榑	anhc
梾	afqm
楉	asel
穎	nmvj
僥	ehhl
攲	oalb
恞	robg
弍	kiri
巊	ujjc
幒	udtr
熖	iudi
熕	ipjb
彫	whlc
榅	ajum
覓	ujjz
譁	bsns
灩	nudu
籄	ghlj
篜	gyni
癶	bo
簕	gssl
橧	aqjj
歀	ajxq
槱	apib
粫	qsrm
眆	jtfm
煠	isau
県	jeiv
撦	fohj
癉	mllg
筜	gibj
穄	mwjs
眐	jfpi
硏	vnng
碢	vrks
稲	muuj
卹	guaj
桯	aljw
敁	ulub
敍	rfab
枌	akmd
焃	ihkk
曒	jdtt
澻	nqto
煚	jhbi
爄	ivsv
毆	hlle
曀	jhxq
潚	nbdf
狉	hgfi
渉	npig
漣	ndoc
狓	hbpq
猋	hhhq
玨	jjww
珖	jilw
珝	jvvx
璊	jsfb
昡	jana
淴	nwcr
浭	nfjs
旵	jusr
斠	schg
椯	ausr
楻	adjw
粃	qnnb
迾	fxmo
絯	oths
馂	xnkt
摚	fiht
鄀	selp
鄡	dapf
醽	pcll
鋿	tisj
錅	mwgt
鐩	tqto
阬	paej
雔	eehh
韄	sseb
韡	bsns
頬	oqvj
饤	xads
駃	wbre
絰	odzs
騂	wkxm
騠	wjfp
魼	vhna
鮎	vulv
敻	xcrt
箇	gwjg
鰃	vvhf
鳈	xdns
鷄	unod
黐	mrnn
黱	wqog
鼕	hgbi
龑	kwuo
讻	dswk
讃	booj
譓	bdri
諠	biff
続	ohxw
緌	omcn
縰	ocpp
縺	odoc
罇	jqph
翝	ienv
聻	nddl
脁	wwii
脢	wgem
膫	woqi
茖	stlv
莂	slsm
菫	sflh
蒄	sxfh
蓇	srgo
蓺	shkk
薬	sdia
藨	smib
藴	soju
虡	uika
蚆	qobc
蚮	qeki
蝪	qjfc
蠸	qsle
袊	xrkb
褀	xuqy
訫	briy
撃	defs
禚	jqib
摐	fcrp
値	egje
餚	ksew
壎	hmgh
擼	fvjr
岍	ufso
瘃	mtkd
摃	fpjb
耱	dkmv
鳆	xgjt
仏	enar
俆	erfa
椏	afka
巹	ynfo
絢	owjr
颳	elsf
偱	edgj
傐	eagr
傞	eqpg
僣	eooj
兏	djwr
兞	jwmm
冡	xfts
冨	xflv
軻	dalv
幀	uujb
冿	ibak
輾	dbsh
繪	orfj
繡	obdf
艶	csfo
燭	iuwq
蘆	suvu
晉	fnnj
檳	aifj
鏽	tbdf
揀	fawq
瘡	mrkl
憫	rdte
椪	aqie
綽	oujz
靂	cvmp
畝	avxk
闌	dawq
顱	uvuj
逕	flpo
馴	wlcm
麤	mmml
髣	utfb
眥	pnjm
倣	ettp
簖	gqed
忳	rxwk
媢	ccij
嫿	cbhf
孉	csle
屛	bgnn
嵕	uswt
嵚	uoxq
巃	ukwu
巚	uufh
幙	usjo
幰	uidr
幵	nngg
広	mnag
弎	klai
彽	ckxk
搰	frgs
搒	faqt
怰	rana
愄	rvhf
抆	ftes
抝	fnyi
捜	fdbo
捵	fcsk
媼	cwru
嵵	ujhh
掁	fucs
営	nxll
嚔	lgxp
芻	wwww
贅	hwtj
嚞	hlhl
唘	vblv
嗃	lagv
呟	lana
勊	jwsl
坬	hugt
嘓	lwkf
剟	bbbm
塨	hskk
墻	hhrl
刓	flmd
壼	hxfk
奍	qoka
嘷	lqig
鄧	bflp
馱	wodm
攜	fuel
錦	tduj
賬	jucb
謢	bebo
綜	oijs
俇	ehjw
紐	obcs
咲	lqod
牀	dauq
铷	oclv
僝	ebkk
乄	ykdi
冃	cirk
廠	mitp
佖	ergp
兡	jwvj
噯	luxt
佪	ewlv
僷	essa
阢	plwf
鏘	tdwh
鹽	hguu
壘	vvvh
塭	hjum
噥	lcsm
卼	lxva
繭	scuq
絹	olwy
鬨	dska
譴	bljo
癟	mqrc
澱	nbse
瀝	nvmp
擲	fqpp
囁	llll
瀾	ndaq
嚀	lira
隕	pljb
虜	uvsl
瓊	jxct
晝	bhjf
鑲	tasg
瀉	nidi
隸	ajbn
冺	ioxi
伮	ecbo
厎	vkxk
膸	wepo
繙	ogqv
翂	vvkm
耭	dknr
耹	lrky
胘	wana
腂	wjau
腃	wqoa
膲	weib
菾	sfok
覥	cskj
蔍	smlo
薫	smvi
藘	suvr
蛼	qdcc
蝭	qjfp
衺	ahgy
褉	xdmo
覇	pswy
緑	obns
綫	okkg
絁	ogoe
箒	gbxu
瞐	jjjm
瞱	jsns
瞶	jljj
矉	jifj
矎	jxct
矘	jigh
殲	fxrf
穠	mcsm
綹	otul
顰	pivg
矙	jdyt
矴	vads
磥	vvos
礐	dssv
祫	jrhs
祲	jbxb
筼	glcb
覠	bglj
覧	hgjj
眱	jobg
鮹	viwy
関	dqod
雊	wleh
霬	cvsk
鞚	sipg
頟	tlvj
髆	rnhc
鬖	unnc
鮝	qovv
鴂	brdn
觹	xsec
鴈	vedn
鴙	jdni
鷘	altd
麃	mibl
叚	bibb
愒	rjwe
晬	jarg
餽	kdgs
鱉	qukv
餿	kdub
癈	mbbe
侲	emcr
觺	njbs
詥	brhy
豋	wflq
赗	ccij
跅	pdkd
踀	ppzz
踦	poal
蹎	pgjk
躄	blkp
輦	oodc
辧	kmkx
遝	unoc
遡	qwwo
邩	ipfh
鄩	bplp
醿	pmos
鏁	tlja
睩	jbns
鉶	tfsm
眔	unsw
靄	cbje
悁	rlwy
愊	rflv
慤	heri
懭	rmsk
抈	fwys
抳	fbnb
抶	fgof
諂	bxdi
揅	vfsf
椸	atgo
搊	fwww
搕	fhnu
昒	jwcp
晻	jodd
朼	anbu
枻	asiu
栃	adfw
栿	aehq
恾	rstw
怤	ehri
忬	rkyx
埇	hbsy
吅	llvv
唃	lxsy
垐	ixht
墥	hkvl
墵	hcin
壡	uxfh
夐	xcrt
奤	osmd
孼	wdkk
寽	uhcz
対	thce
崌	ubjg
巐	uajs
巑	upwj
廸	dgyo
弨	bmlv
弾	bnjg
椓	atkd
挙	nkfs
槖	hxva
玁	hllt
爠	ijje
牸	pikz
犽	hhyq
槡	abba
猂	hjng
獕	hueh
獝	hkgl
玊	jkdw
烱	ickl
珇	jjqw
瑬	nank
璬	jdtt
甁	gngr
畇	vwir
畾	vvvt
皥	dqig
熯	isfo
狶	hseu
炵	itir
澪	ncrb
槺	ambn
櫬	akaj
歭	phhc
歳	pkfi
殹	hjes
毼	jwrm
浄	nxby
淸	nhcj
漦	ftvn
洿	nofh
灋	nmhn
瀂	nvjr
蜅	qnfc
腪	wxdc
簁	gcpp
瀕	npij
籣	gdaq
籧	guto
糒	qsgs
紵	oiad
綀	oalv
蟷	qivt
総	oknr
肸	wkgi
胔	pncr
脦	wkri
膔	wmly
茞	sheo
舋	dcfj
葧	sgxs
莻	sgln
萣	sifp
鑿	iqgt
菨	skcn
葴	skfl
芛	sbgp
苖	sdoo
蝍	qbna
蜑	gpgq
莋	segu
篘	gwww
鉅	thbo
篶	gfpi
睠	jqoa
竒	klyi
盄	buum
矖	jfcm
矕	booj
瞆	jljc
眗	jwlv
眏	jcod
盇	okum
皐	diig
窰	iujf
瘉	mrfm
痳	mira
痡	mnfb
疐	gxvp
璥	jswt
璂	juht
硍	vggs
硑	vqso
碐	vhkt
磂	vkvt
襪	xsuk
磗	vnhc
礵	vcaj
禃	jgjq
禆	jdgi
禑	jvys
紳	odss
撈	fiis
禨	jnnr
禬	jrfj
稭	mnnd
韌	bmkd
穜	mkvl
衵	xjry
闒	djvv
袚	xebk
駥	wkez
骫	rrkd
驎	wqxa
驌	wbdf
騕	wpcn
駸	wbxb
嶼	udhk
馩	mjgj
頃	nvjb
馌	xhnu
饘	kawf
餋	qoks
韨	ayek
踐	pkkg
隩	pdqo
骲	rwos
鬋	uqwm
鷡	gsfd
謀	bsia
鷩	qukd
鷔	hwtd
鴥	dixn
鴏	deki
鱲	vlwb
鹥	hjem
籌	ghyh
鬑	uqbk
瑍	jxco
覽	hguj
鱑	vsdk
鰤	vdfu
鰜	vqbk
鮰	vwlv
阺	pkxk
閛	dnqk
褞	xjum
謿	bgjw
嚮	kgkd
貋	vjng
遼	oqjo
鋁	tllv
诪	ddhc
讟	bhub
読	bhxw
跴	ppxz
覮	iixj
覜	wiij
襴	xdaq
襨	xiqh
襥	xeio
襆	xiqo
跙	pjqz
躙	pdeh
鐭	tdqo
醩	psjj
鵑	lwdn
鏠	ttdo
鍚	tjfc
鋘	tlfo
鉓	tguj
鈿	tvtj
酅	uecp
躝	pdaq
鄃	rfwp
郙	npff
濱	nifj
邤	dpfj
邔	opfi
逤	nigo
瑏	jihy
嵉	uaad
琌	jury
刜	bkmd
咗	lepg
呫	lulv
呧	lkxk
収	wboj
剺	ftvm
亙	fwfi
凂	ixlw
僁	egqr
冮	ipgr
冎	rk
兝	jwkm
兙	jwgi
儽	evvo
儅	eivt
唩	lmcn
唽	ladj
啛	lgbc
啴	lqjg
啽	lrso
嚬	lpij
圂	wtsw
埗	hpiv
珋	jkmw
塩	hglu
塿	hlgc
壃	hfvf
奺	cxkd
娚	cvsl
婌	cjib
孅	crrf
尐	ikdv
働	emvs
傓	ehvv
岞	ugub
礬	assv
驃	wpjs
絛	euto
褻	ahkg
陝	pobb
喞	ldna
詔	bmlv
犛	ftvp
伝	eina
蠣	qvsv
鷲	aifd
懺	rrrf
軼	dgof
躑	pqpp
惻	rjmd
躡	plll
裊	dagy
剮	rmdk
摳	fhll
糰	qwdh
諏	blbo
塥	hflu
屮	wc
弪	bbpg
灬	ib
螋	qdub
赕	ciih
辁	xrjw
铈	oauj
駿	wnkt
頤	hvjb
镤	oiqo
屟	bsau
堐	hvhh
岠	uhbo
椫	aqjg
櫂	avve
檿	vjwa
榺	wqoa
楽	diia
楧	asco
崅	uxsy
譏	bnnr
昜	jfwc
査	ajqu
柫	abka
柤	ajqu
枼	saui
晲	jdwr
晫	jujz
泈	ntir
浹	norr
涙	nhod
闐	dgjk
渞	nqqi
湅	nawq
澼	nblk
澿	naaj
濔	nfks
灐	niit
睞	jalm
煋	ijps
熝	imlh
犠	pqgk
狌	hpsq
獦	hsje
玈	angg
晙	jnkt
楡	abfl
昚	oqjr
頽	mevj
嵰	uqbk
嶈	udwh
巌	unvt
巣	njau
庛	mpnb
昄	jdbo
惷	ojri
愳	jjri
欖	ahgj
慭	fqhr
憭	roqi
懆	rlla
扅	hxxx
扝	ffhk
怹	eori
抦	ffcr
棓	aklv
駟	wwwr
鞳	ssrh
敭	jfwt
虯	qwjc
苺	semo
浡	ngxk
撾	froc
摴	fcfh
搾	figu
揜	frso
掟	fifp
捘	fnkt
挒	ffxm
仴	ewyr
亁	gjny
亽	rkde
仭	emkd
俥	edcr
伈	erir
伓	egur
佁	enlv
铕	oewy
铴	onyc
卩	aj
蒎	sndg
苠	soxi
瀵	nqvk
氕	ggpq
巛	lc
亠	at
齶	pllh
暘	jjfc
慼	kjir
壈	hawm
偋	ebqs
僯	eqxa
葯	sowk
萡	sndb
莯	snau
莈	snes
苼	spso
舎	rhlv
臛	wceh
臅	wuwq
膴	wgsi
膧	wkvl
膢	wlgc
脋	mmmw
脄	weih
胈	webk
聛	ldgi
耎	sodr
萹	shce
蒍	skgw
罶	ukvt
蕀	sacc
斕	tdaq
裖	xmcy
袇	xwat
衭	xofy
蠤	qpqq
蠎	qsos
蟞	qukq
蝯	qunb
蚖	qflw
虰	qadc
虒	duhj
蘹	srag
蘐	sbub
薾	sfks
薁	sdqo
翺	qiiv
罳	uvri
観	gfej
祻	jwjg
礩	vddj
磣	vnnc
磠	vuls
磜	vwjs
碪	vuei
硠	vkgg
硊	vxva
閥	dekg
鈞	twir
攣	boof
砡	vjkd
矱	jseb
睟	jarg
睕	jixa
睎	jseu
祬	jdzs
祽	jarg
罛	uugw
秈	mush
罒	uw
纙	ouoe
繈	obnq
縗	oafg
綷	oarg
滌	neua
絻	oxlw
紬	odos
糦	qhlv
粦	qxak
籫	gpwj
簔	gafg
箾	giwm
筽	glfo
竴	kqph
覗	yflj
觧	xsqy
瘣	mdgb
麰	atnp
鸀	uwqd
鷇	hfdn
鶡	jwrd
鶒	alsd
鵫	ujdn
鵙	jdnb
鵄	ddnz
鳽	fsdn
鳯	ednj
鳮	bdno
鳣	xawf
鳉	xqxh
鮣	vkfa
鬛	uwsb
髩	ujey
鹀	prrm
蝨	ygqq
骭	rngg
詰	bhlv
媿	cdgn
癆	miis
瞷	jdjr
縊	oqku
誆	bhjw
霤	ckvt
鼩	dbwl
齎	aquj
鵜	qbud
謅	bwww
蠔	qats
誠	bkyi
邇	fkuo
鴟	kxkd
颺	ejfc
骾	rfjs
驲	bjrm
訄	rbyj
遱	lglo
逥	wuio
迖	hocq
蹷	vqwp
蹆	pgoc
踠	pixa
跰	pqso
跕	pulv
跔	pwlv
賖	jrfa
貍	vvlz
豷	thxq
謞	bagy
誩	bbyy
誎	balv
詖	bbpy
逹	hqgo
郂	tpfh
驖	wgkj
郉	nnpf
覬	uflj
騞	wdvs
饐	khxq
飡	iksr
飀	ekvt
頩	qsvj
鞕	sfjs
霡	cwkn
雑	raeh
隣	pqxa
閧	dska
鑵	tsle
鋳	tdhc
鈅	twyj
醝	pqpg
眹	jqod
鋡	trkl
畊	vika
峫	uhpf
屽	ungs
孹	blkk
媻	uecn
媬	cela
婬	cumr
娳	cmmd
棧	akkg
娫	cgpg
姡	clsn
姌	ccht
奜	uodf
壌	hakg
偘	elll
墈	hues
墆	hsfu
岰	unsl
嵑	ujwe
塈	bnhh
巆	uiil
恴	ajri
鋸	tbjg
従	cqpz
僞	eugw
諱	bbwy
廹	dgyb
鴿	rdnh
廲	mfcm
庲	malg
庮	mpyg
艦	uhgu
瀆	nhuj
庝	mtir
帰	qbxu
帟	tujy
錫	tjwc
堮	hllh
愐	rsmx
哬	leal
呾	ljfi
貿	kjbm
僼	ecsq
僽	emir
儦	emib
兂	hwrf
販	jdbo
甝	usir
凚	iaaj
凟	ihuj
劏	ivmd
箏	guby
匜	hoef
匁	wsib
勚	scsl
咮	lpka
哻	ljng
埰	huau
唒	lpyv
埫	hist
銜	ctic
埢	hqoa
埑	fdht
垵	hicn
嚱	lufk
嚘	lvwt
噰	lake
颱	enlv
嘐	lvvc
腎	hbwy
嗹	ldoc
喢	lmdi
喎	lrkv
啀	lvhh
悗	rxlw
嚲	aklg
慱	rdhc
瑴	hfjw
灺	ioeh
灈	njje
澙	ndhi
蹣	psfb
懾	rlll
蛻	qklw
柵	aceu
潠	nook
漋	nptp
漅	nlja
湹	nvvl
涢	nlcb
涗	nklw
洟	nobg
泒	nugs
撓	fhhl
琫	joak
汒	ntws
珢	jggw
犲	hhgp
犾	hhqq
憕	rbfq
狖	hixq
狟	hfjf
猯	husr
獈	hqku
獽	hasg
玞	jofw
玾	jvjw
痙	mflp
牷	prjw
煟	ivwy
焞	iakz
烸	igem
漬	nhjb
淍	nwhl
汈	nyfi
揢	fitl
鬢	uifj
氄	kgcm
朖	wkgg
暡	jknv
撗	fsdk
搇	frkg
藹	sbje
捄	ffnk
柎	aehc
挍	faks
慚	rddj
抲	falv
抧	flka
戄	rjjb
懰	rktm
懃	sisr
柆	aklu
柂	agoe
柲	argp
槦	ambw
檍	akjr
欃	axlk
澗	ndjr
榚	aqib
轄	didl
饗	kgkk
毑	eoem
楺	akga
楜	ajwy
棸	lbau
瑽	jcrp
棡	acqu
梡	aifl
檇	aeck
蒧	skul
脃	wxob
菮	smbr
芀	smdo
莚	sgpg
荙	sooc
茦	sack
腒	wbjg
艎	udjw
舩	ukna
舕	liih
臽	xdim
膯	wbfq
膭	wljj
葏	snba
觡	xstl
蒮	sxeh
蠠	sqqc
詄	bgof
訉	bekd
聇	lfpi
覌	bjjo
襶	xgkk
襢	xawf
褩	ueag
褦	xnwn
褘	xbwy
裓	xkso
袺	xhlv
衏	cfli
蝱	tqqc
蓨	seuw
蚠	kmqc
虷	qngc
虵	qoec
虌	squg
虅	swqw
蘗	sbla
藳	samh
薭	smdg
薖	sroc
蕫	skvl
蕚	sllh
蔿	sugw
胾	gkcr
簼	gfsh
耮	dkis
耬	dklc
篔	gljb
箁	gklv
筶	gplv
筰	gegu
笯	gcbo
竂	ioqi
窼	ilja
窵	idnx
窞	ixdi
穵	iyix
穨	melj
穔	msdk
稕	makz
秨	mgub
禴	jrce
禢	jjvv
禐	junb
祃	jbms
礚	vshu
誜	bnkt
礕	blkv
篯	gofk
篸	gnnc
簝	goqi
纎	ogkf
耤	dksj
翍	vvbp
羾	vvpg
羱	qvdi
羭	qrfm
羣	bglq
罫	uhhu
缻	jrwf
纴	kmrj
繘	okgl
籇	gats
縁	obts
緅	olbo
綖	ogpg
絏	odgp
紽	oinb
糹	os
糀	qsen
粌	qbus
籑	gjog
誂	bwii
鯈	eutv
諝	bypw
鵅	tldn
鴽	cldn
鴢	nsdn
鴡	jdnq
鴗	kdnl
鳪	udnb
鳠	xseb
鳑	xaqt
鱬	vcsr
鱇	vmbn
鱄	vdhc
鯭	vkum
鮛	vjiv
鮕	vjgv
鮆	pnvv
魜	vrev
魎	dfub
髳	ukgp
髪	uebo
騧	wrkm
騐	wrkr
駔	wjqm
馞	mjgk
饟	kasg
鵁	aksd
鵌	drfa
謩	sjob
鵞	gfkd
砠	vjqs
鼵	dbih
鼒	hgjd
黽	gm
黲	gnnc
黗	gxwk
麅	mwos
鹠	kvmn
鸓	vvvd
鸋	irud
鷮	mlcd
鷑	gkdn
鶵	wwwd
鶛	nndd
鶌	bwwd
鶋	bjdn
鶅	lvdn
鶀	duqn
鵾	jnnd
鵸	oald
鵷	ixad
鵵	xlwd
鵟	hjdn
餲	kjwe
餟	kbbb
飱	fxks
飬	qokg
醡	pigu
醙	pdub
醕	pajr
酖	pxwr
鄈	bfop
邟	aepf
遶	hhho
逴	ujoc
逎	pocy
迌	wocy
迊	fuoc
轏	dbkk
轀	dwru
輶	dqpy
軱	dugc
踤	parg
踛	phkh
跁	pobz
趹	pbre
赯	hkkl
赥	hkkx
讄	bvvv
譑	bmll
醧	phll
醹	pcsr
銍	tdzj
闝	djtp
颩	ecpf
顟	vvrj
頣	hvjb
頚	bhvj
韏	qobw
鞺	siht
霩	cakp
雗	gjge
陑	psrf
陁	pgoe
鐡	tgkq
銶	tfnk
鏻	tqxa
鏄	tdhc
鍖	tuei
鍀	tjfh
錿	tuhj
錋	twwy
鋥	tljw
鋎	tifl
鋉	talv
鋂	tgem
磼	veau
嶶	ucfe
砅	vnss
挀	fdgy
廮	mjjc
庱	mhkt
庪	mfgb
幓	unnc
幎	uxjk
幍	uudi
幇	hhhu
帡	uqso
帗	uebk
帎	uxwr
嶳	uthh
嶦	uxvb
嵣	umbl
崕	uvhh
岨	ujqs
岒	urky
屩	bcml
宖	ibna
嫲	cman
娗	cmgy
姟	cthn
妔	caej
夑	biit
廼	pgyx
弙	bfhc
彍	bmsk
慅	rbkq
抋	fris
扲	frky
扤	flws
扊	hiih
戝	jkgb
懫	rddj
懤	rhyh
懐	raug
慩	rdoc
慔	rsjo
愞	rsod
徏	cpiv
悮	rlfo
悊	fdri
悆	rfar
恜	rkpg
恌	rwii
怚	rjqx
怗	rulv
忚	roex
忔	rgyi
忋	roix
壊	hgug
墠	hllg
塁	viih
偮	elle
匋	wjfb
勠	vvrs
劘	mumd
刦	hnmd
凔	irkl
冋	clvk
兤	ilmk
儗	enjp
僩	edwy
傃	ehos
偟	edjw
厡	vdns
倈	ealr
伇	eesr
仛	egxi
亅	yi
齄	qvlf
鲕	xsrv
茚	skfa
冫	ir
絝	oofh
墶	hhqo
卭	pajg
叕	bbbb
堧	hsod
嘽	lllg
埶	hkhk
垰	hjjx
垇	hcfi
坧	hvst
坆	htpt
団	whcw
嚾	lsle
嚰	lmvs
噈	laif
噅	lugw
嗰	lewj
叧	lmdv
嗩	lijb
喥	lmsb
啋	luau
唂	lkrl
哷	luhc
咺	lfjf
咘	leuj
呰	pnlv
呅	ltev
吷	lbre
抭	fiej
捰	fjau
矼	vpgs
捸	fbns
犑	pjhq
牓	daqt
煯	innd
煃	iohh
焴	ianw
焝	ikxj
烢	iigx
烇	irjw
炴	icod
炡	ifpi
灴	ipgh
灒	npwj
灀	ncaj
瀽	nisp
濴	niin
濗	nsju
澩	dssn
澘	naaj
潯	nbph
漰	nuww
漟	niht
滺	neur
渇	njwn
犘	mpna
犡	pvsv
猧	hrkq
癿	deib
矨	jmyi
瞏	uhlg
瞉	hfjm
睳	johh
睙	jhhq
眴	jwjr
盺	jdjm
盕	neku
皪	ddna
皠	dueh
癹	beso
玓	jwkd
癝	mawj
癊	mprn
痑	mxxx
痏	mewy
疎	ypal
畺	fvff
瓽	irws
瑡	jdfu
琸	jujz
琲	jufw
淈	nbww
涾	nnjr
涳	nipg
斨	ddjq
棃	mwga
梘	ajju
桟	aikg
栐	akns
枃	awir
杴	axqu
暦	vaaj
晱	jiih
旹	wfjr
斵	kfkd
斎	tkjs
榎	avjt
斄	ftva
敼	hlub
敨	kltp
攦	ffcm
擉	fuwq
搳	fidl
搲	fiug
搉	fxeh
揘	fdjw
掑	fuqs
楟	aaad
榙	asrh
浧	nljw
殾	hjes
浖	nuhc
洝	nicn
洅	njck
汵	nrky
汚	niei
汌	nlcs
氶	ynsi
氉	lllm
氃	kvmm
毰	mklv
殝	fxom
榥	ajil
歵	phjb
歝	uhqx
歈	rfwx
歂	usxq
櫉	avhh
檵	anne
檊	agjn
橾	alla
橞	adri
樻	aljj
嫺	cdwy
闘	dflh
藷	sbhj
駒	wwlv
箋	gkkg
瞼	jrqm
劊	rfjm
惄	jibr
殞	fxlj
紆	ofhc
頦	tvjb
橢	apew
勛	ljsl
駑	cbwm
礫	vdna
蒞	snek
輓	dxlw
觴	xsgc
廩	mawm
闡	dllg
驛	wuhg
鐸	tuhg
儂	ecsm
藪	slgt
閘	dvjm
滷	nuls
諳	bkjr
鉗	tsir
閨	dhht
竇	ihuj
蹌	prkl
鴛	xadn
訟	bkna
慟	rmvs
慫	crrr
摻	fnnc
緘	okfl
謄	wqob
暉	jxdc
驢	wuvu
鏤	tlgc
殤	fxgc
燬	idpe
絳	otak
螻	qlgc
繳	odtt
貶	jgoz
躱	qgau
廄	mbne
輿	ddfk
齜	ppnb
諶	buei
誥	bplv
誑	bhjw
繾	oljo
砯	vkns
嶔	utxq
柀	abpu
躂	phqo
輻	dflv
伡	exjr
粬	qcso
偸	ebfl
籦	gtmv
偒	ejfc
倴	eogs
倰	ehkt
倎	ecsk
倃	etul
侒	eicn
簶	gjbn
簚	guku
篺	gfdg
箥	gnbp
箣	gacm
箘	gwmh
箑	gfbp
箆	gcrn
侐	egum
筬	gkyi
粖	qfmm
粻	qucm
仸	emyr
糱	wdkq
僾	euxt
僶	egmr
僤	ellg
傫	evos
傛	eirl
傔	eqbk
偺	etuj
纆	oght
繦	oblq
縧	oeua
縏	ueos
緺	orks
緛	osod
綳	owwy
児	ujwr
継	oqei
綅	obxb
綄	oifl
絅	oclv
筓	gnng
笒	grky
笀	gtwz
窻	idtr
礮	vwas
刵	lmde
礔	vblk
磒	vljb
刐	wamd
磇	vdsn
凾	klbw
誒	bnji
鼔	hubo
彐	bj
鲴	xwjg
凓	ipau
兿	qfrn
兦	beiu
兣	jwvv
鲺	xygq
鳋	xbkq
丄	jv
乁	yi
祋	jess
祾	jhkt
禜	iixj
労	nxsl
穏	mubr
稯	mswt
稑	mhkh
秼	mpka
匼	hrhf
匉	wnqk
勦	ljas
儬	ehwj
剰	msmd
禡	jwms
佋	emlv
剣	rrmd
秥	mulv
刼	hnmk
秔	maej
禼	uwsn
禲	jvsv
禣	jnhc
儻	eigh
圀	wktf
纑	ouvu
謋	bxaa
貣	kjbi
貆	vfjf
豲	tvdi
豘	txwk
豀	krlo
谾	krlp
谺	krlh
诇	dclv
讱	dmkd
謷	hwtb
謧	btwn
謓	bgjk
諴	bkfl
纕	oasg
誳	bbww
誃	bxxx
詾	bwsw
訔	ubys
觿	xsul
觭	xsol
觟	xshh
覻	uflj
覣	mcjj
覔	gjju
覅	pcwc
襾	px
賮	bfij
贔	jjjb
赩	hkko
趍	hxxx
慳	rhbh
懟	iqhr
戇	kjtr
摶	fdhc
棝	awjg
槙	agjk
灤	nboa
癬	mvqy
癵	mbor
礨	vvvv
笻	gpaj
羆	unwi
莢	sorr
蕎	smll
裌	xorr
覈	pdtt
軔	dmkd
闓	dufq
駪	wpwr
鼱	dbhw
踳	pojr
跱	phhc
趽	ptfz
趬	hhhl
趗	hpzz
褽	bjhg
褁	jagy
裿	xoal
苲	sgub
苢	sbbo
芺	smyo
芚	sxwk
艭	ueeb
膵	wsag
膞	wdhc
膗	wueh
膍	wdsn
膇	wdoc
腁	wgnn
脝	wake
胣	wgoe
厷	enaz
胊	wwlv
胉	wdby
耾	lena
耏	scpr
耇	hwlv
翫	vvdl
翧	ifjv
翖	rvvx
羓	qoby
罎	jjcn
缾	jqso
纞	obor
苭	snsl
荂	sofh
裐	xlwy
荓	sqso
袦	xwwk
衱	xgkd
衞	cbli
衘	cgfi
蠜	assq
蠂	qssa
蟫	qpjz
蟕	qpns
蟌	qdtr
螾	qifk
螀	qxhq
蜨	qfbp
蛖	qfcp
蚎	qjrc
虖	ugqh
蘷	sfpt
藂	slbi
薢	sxsp
薋	sixj
蕯	sptp
蕥	sheh
蕠	sclo
蓃	sdub
蒱	sfnf
莁	sprr
厞	vufh
噋	lakt
吤	lrka
瀺	nxlk
沕	nwcp
泏	nwwk
洭	nhjw
洰	nhbo
浕	nbki
涖	nekl
淽	nspi
渓	nuof
渕	nqom
湪	nets
溄	nuta
溇	nqcn
溋	ngbu
溎	nahh
溓	nqbk
溕	nxft
溞	nbkq
滭	njsa
漒	nblq
漘	nmwy
漙	ndhc
漛	nqon
漴	nuij
澟	nawm
澫	nsvy
沑	nbcs
汦	nkxi
氿	nrjs
梴	agpg
枮	aulv
柅	abnb
柛	adsu
柣	agof
柪	ansl
栔	dmau
桍	aofh
桚	alxx
桭	amcu
桮	aglv
梣	aury
棈	ahwy
氀	lglm
棙	ahhq
椄	akcn
椝	ocau
椲	abwu
槀	aaug
樕	aalx
檖	aqto
檚	aaap
毃	aesg
毉	hjer
毾	jvvm
瀓	ncfj
灂	nuuh
枆	ammu
烣	ieih
瑓	jawq
瑝	jdjw
瑦	jdww
璒	jbfq
璚	jkgl
璲	jqto
瓀	jcsr
瓐	juvu
甹	dhko
甿	vtwt
疕	mnbb
癅	mlhv
癑	mcsm
癠	maqi
癰	mlle
皜	dagb
皫	dmib
皭	duuh
皯	bngp
盌	xaum
盨	cvju
眜	jfmm
眰	jdzm
瞯	jdwy
砄	vbre
瑐	jqwm
琣	jklv
琞	jwjk
牗	dmbw
焣	lbib
焻	ijjr
煄	imvl
煱	irkh
煻	imbl
熤	ivvk
燫	imqk
燸	icsr
爂	dcfi
爟	isle
爼	ssjq
犎	hhhp
琗	jarg
犵	hgyi
猘	hpcm
猵	hhce
猺	hujf
獂	hvdi
獆	hdog
獣	nvfh
獩	hpki
獳	hcsr
玍	ghtz
玤	jdfw
枟	aina
杸	aesu
呌	ligi
巺	oofk
婓	ucnf
婘	cqoa
婭	cfka
媕	crso
媖	csco
媥	chce
媮	crfm
嬎	cxlp
宷	igqm
寉	iehb
寏	ixco
寕	ivua
尗	jivv
尟	jfpg
屧	bcsa
岥	ubps
峐	uths
崀	ukgg
崱	ujmd
崵	ujfc
嵍	kgtu
嵒	lllu
嵗	ukfi
嵺	uvvc
嶛	uoqi
娙	cflp
娍	ckyi
妌	cika
噺	lkad
呍	lina
咃	leoe
咡	llev
咢	llfh
哵	llsm
唍	lifl
唥	lirb
啌	lipg
嗺	lueh
噂	lqph
蹜	piej
嚢	glxg
奵	cadn
嚵	lxlk
硩	fdvs
圤	hubt
垝	hxva
埧	hjka
埨	hrfc
塀	hbqs
夆	tdfp
夊	tp
夣	anux
夻	olvd
巓	unjj
帞	uvjr
朿	acku
廐	mbnw
搨	fjvv
摖	fwjs
摪	fdwh
撛	fqxa
撶	fsns
撹	fnxj
擪	vjwf
攖	fjjc
敃	oxtp
敔	fblt
斀	uwqb
斮	sjdj
旑	toal
旙	tgqv
旴	jfhc
旽	jxwk
昤	jrkb
晄	jilw
暩	jwjs
暳	jddb
暵	jsfo
曕	jxvb
朌	wkmd
朜	wakz
朾	aadu
搤	fqku
揓	ftgo
掽	fqie
慛	rueh
弰	biwy
弸	bwwy
徯	cuno
忟	rtex
忴	rrky
忹	rjwx
忼	raej
悕	rseu
惢	rrri
惪	gjri
愵	rbii
慯	rgjc
掕	fhkt
慲	rsfb
慴	rvvd
懝	rnjp
懴	rgkf
懹	rasg
扖	fbus
扨	fmkd
抏	fflw
抣	fwir
抩	fcht
挭	ffjs
蹏	pduh
醷	pkjr
蹳	pbbe
龤	rcnd
繕	oqql
歟	dhjx
鼛	hgbl
鼣	dbhq
鼫	dbvs
鼸	dbqk
齌	aqui
齏	aquf
龂	prwd
韾	hbej
訥	bcre
芐	sjxo
脛	wflp
渙	nxco
婁	lglc
鮪	vewy
驁	hwtw
薔	shrl
煬	ijfc
嗇	hrrl
薊	svmd
讖	brrf
貲	pnjb
鸔	djsn
鵋	ordn
鵮	xddn
鶄	hwdn
鶏	uodn
鶔	kgad
鷣	pjdn
鷵	bhjd
鸉	ajfd
鸐	vved
鸼	umno
贛	kjtj
麉	nnml
麖	maiv
黤	godd
鼃	hhgm
鼇	hwtg
鼈	qukg
鳩	rdnj
餉	kdxs
閂	dfim
躠	sdkp
訐	bngy
鲯	xuqv
鸚	jjcd
鋤	tjsl
繹	ouhg
膿	wcsm
聾	kwul
檯	ahld
賈	pjbx
廈	mvjt
攬	fhgj
嶄	uddj
鯉	vvlv
謐	brgu
賄	jewy
煥	ixco
蟬	qllg
篩	gdfu
鉛	telv
僑	emll
軸	ddoc
朶	gaun
憲	idur
鶯	iixd
癥	mcfj
嚶	ljjc
諄	bakz
儺	esfe
鑣	tmib
犢	phuj
錨	tsvt
皚	dufq
縹	opjs
擰	fira
餌	kles
錡	toal
樺	asns
諦	baqu
噸	lxwj
賂	jtlv
撣	fllg
緯	obws
濘	nira
瘓	mxco
誨	bgem
堊	fkht
縐	owww
鳡	xkfr
砆	vofs
鲖	xcfl
邘	fhpf
郷	kgbp
郚	fblp
鲉	xdov
邷	rpfw
靯	shtg
鞈	srhg
鞉	swii
韖	bkga
韲	aquf
邥	xwpf
迼	hloc
輹	dgjt
鋗	tlwy
迠	uloc
鏣	tmsi
鏔	tifk
迆	ooce
辤	uxbk
鋬	fdbt
鋮	tkyi
錎	txdi
輼	djum
郼	bpfw
鐍	tkgl
鐕	thwj
鉼	tqso
鉁	trcp
鉔	thuj
砶	vdbs
醲	pcsm
阤	poef
铔	olqk
阹	phna
钁	tjjb
醤	quhp
鑚	tooj
酔	prgi
陃	pfcr
陗	piwy
隤	pljj
雟	wecl
霦	caac
鄷	csfp
鉰	tyfl
鄮	kjpf
鄨	quko
鉲	tjub
錽	tfit
鉾	tnpn
鍮	trfm
餠	kgnn
餻	kqib
馝	mjrg
鱖	vvqx
鯁	vfjs
鍬	tmih
襠	xivt
臚	wuvu
聶	llle
癘	msvy
馿	whhm
駓	wgfi
駞	wgoe
駬	wlem
駴	wkso
騹	wsir
髝	aiis
髞	alla
髷	ucso
鬉	uswt
鬎	ualm
鬐	uhnj
魊	dklf
魛	vmdv
鮌	vana
鯢	vdwr
餸	kqoo
馡	mjuf
醸	pakg
転	dina
軨	drkb
頜	rvjb
韷	kjww
顡	ktvj
鎁	tlpf
躨	pqqt
輀	dsrc
颬	ehyf
飃	epjs
輅	dtlv
餈	ixks
鏓	tdtr
楕	aepw
椊	aarg
歴	vaap
楤	awcr
楥	aunb
殏	fxfk
汮	nwir
歑	ugqx
毧	mkez
毱	mwqm
汥	ngbo
汋	nwkd
楄	ahce
椑	adgi
汃	nkas
歜	uwqx
欿	xdxq
楬	ajwe
榗	alqj
欱	rxqh
欍	ased
櫽	pupa
櫴	aalj
櫱	wdka
檨	aqix
檝	allk
橖	aiau
氼	nres
橔	aakt
橎	agqv
橉	aqxa
樥	astd
樆	atwn
槮	annc
槢	avvd
槞	akdd
沇	nnwr
槂	akgo
歍	dxqw
榯	ajhh
汷	ntps
朥	wiis
椈	awqm
昅	jgkd
斚	nnxg
斉	tkir
敎	sekt
敇	actp
攰	gbsl
攋	falj
擽	fdna
擳	fgba
撽	fdtt
撧	foxo
撌	fljj
撁	fanp
撀	hbef
摿	frkj
摡	fbnw
摠	fdtr
摍	fiej
搹	fflu
搝	fqhq
搙	fmhc
搃	fqlr
揷	fmdi
揫	mifs
揕	fuei
掿	fsel
掝	fklf
掗	ffka
掍	fjnn
捼	fmcn
旝	tgrj
昸	jtir
椃	auhu
昹	jkns
棔	akxj
棊	uauq
梮	abyl
梛	ayap
桻	atdf
桪	abhc
桜	ancn
桇	clau
栟	aqso
栞	nnau
栄	nxau
栁	axaj
枑	afem
枏	acir
杝	aoeu
杕	aodu
杍	akzu
朲	areu
朩	au
泜	nkxk
朡	wswt
朎	wrkb
曞	jvsv
暰	jcrp
暛	jqpg
暔	jgcg
暅	jrff
晎	jska
晇	jofh
泃	nwlv
溤	nwms
泬	nixs
洣	nqms
畵	bhvw
疁	vvvc
痌	mcfl
痗	mgem
痟	miwy
痵	mmkz
痽	mehb
瘚	mqwx
癐	mrfj
癗	mcvt
皃	dwrb
皗	dwhl
皵	sjbp
皻	ujbp
盁	gumn
甗	uflr
甖	jjrw
甋	aqcr
璗	njfk
珷	jfkp
琋	jseu
琟	jehw
瑥	jjum
璕	jbph
璖	jnha
璙	joqi
瓬	trwf
璯	jrfj
瓂	jshu
瓆	jddj
瓙	jhyi
瓟	uwos
瓪	rdbo
盋	ebku
盚	fnku
盭	nhqu
碮	vjfp
硙	vuoi
硜	vflp
硞	vplv
碀	vxby
碆	nbvs
碙	vcqu
碶	vdmo
硄	vilw
礏	viqk
礖	vdhk
礘	vjni
祊	jtfs
祍	jmrs
祤	jvvx
硋	vths
砳	vvss
盽	jdfm
睼	jjfp
眂	jkxi
眅	jdbo
眑	jnsl
眓	jkei
眣	jgof
眿	jkns
瞃	jdgj
砊	vaej
瞔	jhjb
瞡	jojj
瞮	jant
矐	jceh
矺	vgxi
砇	vtes
珛	jewy
玸	jwos
獉	homh
漄	nuvh
溈	nkgw
溙	nons
溡	njhh
溰	nufq
溵	ndbe
滆	nflu
漇	ncpp
湬	mins
潐	neib
潡	nakt
澊	nqph
澰	nrqs
濅	nibb
濈	nllk
湴	nqie
湩	nmvl
濸	nsrl
涽	nkxj
浻	nckl
浾	nhkk
涍	nhkz
涐	ngfk
涒	nbgl
涱	nucs
淜	nwwy
湗	nhhh
渂	njte
渘	nkga
渨	nvhf
渹	nwby
湋	nbws
湑	nypw
濏	njjg
濿	nvsv
猼	hnhc
爕	biii
熸	ihwj
燓	assi
燖	ibph
燲	issj
爀	ihkk
爓	idxd
牕	ddtr
熞	ihbh
牳	pemn
犉	pakz
犕	psgs
狘	hkei
猍	halq
猦	hefq
熷	iqjj
煫	iqts
瀁	nqog
烍	ipwr
瀒	nafl
瀖	nceh
瀫	nhfo
灊	nhwu
灪	najc
炚	jihr
烖	gkih
煡	ibag
烮	fxmi
焆	ilwy
焤	mehi
焭	iixe
煏	iflv
煔	iiul
牜	pn
卽	dnaj
挱	fnig
祰	jplv
雽	cgqh
雘	wasb
隬	pfks
隀	pmvl
阫	pguf
阠	pygi
阓	tljc
闤	dufg
閼	dtri
閮	dmgy
閞	dnso
镺	umyc
锠	ojjr
钑	ogkd
鑷	tlll
鑬	thgj
鑤	tjsn
鑢	tuvr
鑞	tlwb
鑕	tddj
鑔	tiwj
鑋	dflt
鑀	tuxt
鐶	tufg
鏙	tueh
鏕	tmlj
鏉	talx
鎫	tdst
鎛	tnhc
霚	ckgt
霝	clll
霫	cvvd
頾	cvjn
馹	wjrm
饍	kqql
餼	kgqm
餪	ksod
餎	ktlv
餄	krhs
飶	krgp
飦	kngs
飈	eiii
颣	qovc
颕	njvc
顑	kflj
顇	arrj
頳	hkkj
霿	ckgj
頨	vvvj
鞹	sakp
鞵	suno
鞟	sakz
鞜	snjr
鞙	slwy
鞌	icsg
鞄	swos
靽	sqak
靱	smkd
靭	smkd
靋	cnvp
靆	cino
鍉	tjfp
鍇	tnnd
錬	tajr
迉	bocs
鄔	dpfw
鄏	mhpf
鄊	kglp
鄅	gqcp
郶	kllo
郰	lbpf
郣	gxkp
邿	hhpf
遰	sfxo
遉	ujoc
遅	bqoc
逓	diuo
逈	docx
辺	mocd
鄼	oojp
辵	cpzp
轣	dvmp
輳	dofo
輮	dkga
輭	dsod
輢	doal
輚	dkkg
軵	dehc
軪	dnsl
軥	dwlv
躣	pjje
躉	svpz
躈	pdtt
鄛	ljap
酑	pfhc
錉	tkxj
鉌	tmhj
錆	thwy
鋵	tmej
鋞	tflp
鋄	tfib
銾	tpns
銼	trrh
銻	tqbg
銸	tlei
銢	tins
銕	tobg
鉞	tkei
鉚	tkmj
鉙	tlka
鉊	tmlv
酟	pulv
鈩	thhj
鈦	tokd
鈛	tkgj
鈒	tgkd
鈃	tfso
釡	ktja
釟	tkaj
釂	puuh
醘	phnu
醔	mipy
醎	pkfl
醊	pbbb
酧	pihc
馽	wlus
駄	wokd
駌	xawm
鷋	srfd
鸆	ulfd
鸅	uhqd
鸄	dttd
鸃	dqgk
鷽	dssd
鷷	qphd
鷧	hxfd
鷢	vqwd
鷞	ossd
鷜	lgld
鷒	dhdn
鷏	gjkd
鷎	dogd
鷂	ujdn
鸒	dhjd
鷀	qnnd
鶾	gjgd
鶽	egdn
鶶	mbld
鶭	otdn
鶬	rkbd
鶨	etdn
鶠	hjcd
鶟	ihdn
鶞	dgjd
鶝	flvd
鶗	jfpd
鶆	adnl
鸍	fkud
鸕	uvud
鵽	bbbd
鼟	hgbq
龘	kwuu
龎	vkwu
齻	pgjk
齵	pvyc
齢	pqwb
齟	pjqc
鼶	dbdu
鼲	dbxd
鼰	dbjb
鼮	dbmg
鼭	dbhh
鼨	dbti
鼤	dbte
鼚	hgbu
鸙	rcdn
鼘	hgbf
鼉	llvg
鼂	jfgm
黵	gxvb
黮	guei
黁	mmjr
麫	atje
麨	atig
麔	mtul
麐	mtlv
鹺	uqpg
鹝	flcm
鸤	bmns
鵿	djgs
鵺	aexd
騋	walm
鬶	ocfu
鯥	vhkh
鯤	vjnn
鯆	vnfv
鮸	vxlw
鮯	vrhv
鮟	vicn
鮈	vwlv
鮂	vwre
魿	vrkb
魣	vkyv
魠	vgxi
魓	djsa
魌	duqg
鬳	uflu
鰅	vvyv
鬙	uqjj
鬊	uojr
鬂	udfk
髼	utdf
髺	ulsb
髶	uleb
髤	uaub
髄	rewo
骳	rbpg
骉	bbbm
驒	wllg
騺	hqgw
騝	wbag
鰂	vjmd
鰎	vbag
鵴	wqdn
鴍	tdne
鵱	hkhd
鵧	qsdn
鵛	flpd
鵗	seud
鵖	bndn
鵀	emdn
鴾	npdn
鴶	hldn
鴱	ssdn
鴮	ofhd
鴩	godn
鴔	godn
鴐	sldn
鴆	xwdn
鰬	vute
鴀	gdnu
鳿	jdnw
鳻	kmdn
鳺	odnf
鳹	rkyd
鳭	mdnd
鳦	dyin
鲹	xnoc
鱨	vinj
鱧	vcsq
鱎	vmll
鰼	vvvd
鰶	vwjs
躃	pblk
蹹	prvv
蹫	pkgl
翜	vvor
脌	wgak
胻	wcic
胦	wcod
胕	wehc
胏	wgeg
肨	wdfy
肕	wmkd
肁	hbak
聦	lwcr
耊	hdzt
翽	pkfv
翭	vvej
翪	vvst
羬	qkfl
腇	wmcn
羥	qflp
羢	qkez
羇	usol
罼	ujsa
罙	xkau
纚	ofcm
纇	qovj
繸	oqto
繏	oook
繎	owhi
縶	hqgo
縕	owru
縆	orff
脻	wfbp
腉	wdwr
緉	ofub
艃	uvlo
莤	spyo
荺	shwi
荄	stho
茿	spek
茷	sekg
茘	smmm
茐	swck
苿	sfwo
苪	sfcr
苆	sxmd
芲	srnb
艗	uqku
艍	ubjg
舠	umdo
腛	wbdz
臹	dkyi
臷	gkdz
臶	deuk
臝	tjau
臕	wmib
膼	wroc
膹	wgsj
膬	wmmm
膎	wuno
膋	iixw
腯	wdgj
腨	wusr
腜	wsia
縂	oqlr
緄	ojnn
菎	sjnn
穋	mvvc
竪	hbkl
竝	kkll
竚	kiad
竘	kwlv
竏	kmql
竉	ikwu
窽	injx
窶	ilgc
窲	iqig
窚	ikyi
窌	ikmx
窂	ipnx
穲	mfcm
穈	mmha
筄	gwii
穅	mmbn
稾	amhg
稴	mqbk
稢	mklf
稝	mwwy
稛	mwmh
秢	mrkb
秇	mrkd
禸	cnak
禯	jcsm
禕	jbws
禌	jqnn
祶	jqbg
筁	gcso
筈	glsz
綟	ohhq
籕	gakv
綍	ogxk
絫	nnno
紩	ogof
紁	obkd
糑	qbii
糐	qnhc
粯	qjjm
粚	qgoe
粓	qsir
粍	qmmm
籿	qhcm
籨	grxq
籘	gwqo
簹	givt
箎	guhz
簳	ggjn
簱	gtuq
簙	ggnh
簘	gbqk
簗	gnma
簒	gjon
簆	gifb
簂	gwkf
篬	grkl
篏	gsix
篅	gusr
箵	gigj
箛	gkug
莬	sxlw
菒	sjau
蹢	paqj
觼	xsxt
諰	bvri
諯	busr
諟	bjfp
諑	btkd
諀	bdgi
誽	bdwr
誻	bnjr
誶	barg
誖	bgxk
誋	bori
詺	bxlv
詷	bcfl
詍	bsiy
觤	xsxa
謱	blgc
觕	pxsy
覸	djjj
覰	ujjj
覢	iijj
覍	ijjv
襳	xrrf
襚	xqto
襘	xrfj
襅	xjsa
襂	xnnc
褷	xcpp
褱	aung
褢	adgy
謉	bdgy
謴	begj
袽	xclv
贀	hjej
踒	pmcn
踑	puqz
踂	plei
跜	pbnb
跍	pjgz
跈	prcp
趤	hivs
趡	hehz
趝	hrkr
趘	hbmm
贜	jskh
贕	kkkj
贐	jbfu
賷	gllj
謵	bvvd
賍	jmht
貳	kijb
豰	hfts
谹	krln
讐	eeby
讁	baqo
譻	jjby
譵	biqh
譳	bcsr
譮	brfj
譒	bgqv
譂	bllg
譀	bylt
褃	xpwy
袘	xgoe
萮	srfm
蔕	ssfu
藅	subm
薵	shyh
薳	shlo
薥	suwq
薣	shgb
蕧	scgt
蕣	suxa
蕝	soxo
蕘	shhl
蕑	sdwy
蕋	sppp
蔪	sddj
蔠	soti
蓴	sdhc
藗	salo
蒭	swww
蒬	sxxk
蒣	scra
蒁	sako
蒀	sjum
葾	sxar
葹	stgo
葨	svhf
葖	sihq
葓	snsk
葂	sxls
萵	srko
萯	sxjb
藋	svve
藛	sidi
袏	xepg
蝡	qsod
袃	xmag
蠿	nnfq
蠺	fofq
蠨	qsbf
蠏	qxsp
蟨	vqwq
蟏	qsbk
蟎	qsfb
螶	hbqq
螝	qdgc
螘	qufq
螐	qdwc
螆	qqnn
蝃	qbbb
蘛	suew
蝁	fkqc
蜲	qmcn
蜪	qwjf
蜄	qmcc
蜁	qgyp
蛣	qhlv
蛓	gkqc
蚹	qehc
蚔	qkxi
虙	urgp
虆	svvo
蘯	snju
蘤	sdug
挴	fgem
忈	irir
挘	figs
腙	wijs
纓	ojjc
檣	ahrl
掄	frfc
囈	lshn
奬	dwho
嬈	chhl
崟	utjs
煒	ibwh
彡	cp
荮	skhc
鈉	tcre
蟓	qxlt
轷	xgqh
钶	oalv
铥	omna
铹	osxs
丼	sato
乭	vyis
亷	kgbk
仮	edbo
轡	odol
魷	vfov
咜	linb
誣	bprr
顢	sfuj
頇	nvjb
貽	jnlv
訃	buby
薺	saqi
縝	ogjk
櫺	acll
攆	food
囀	lddh
闃	djhq
鯽	vbna
刴	gamd
囪	dckd
殯	fxij
瀋	nigv
覦	rfwj
龕	rkwu
鶻	rdng
鶺	iird
鳶	kdni
伃	ekyr
伒	edjr
伭	eana
勲	mvsi
刌	hmdc
剢	tkmd
剳	srmd
剸	dhmd
剻	uwwm
劗	pwpm
勌	qoas
勥	blqs
勯	awls
匟	haej
伵	ewwr
匵	hhuj
匽	hjcn
卄	so
単	njgi
厀	arna
厤	vmmh
厱	vrqh
叞	bjbo
叺	lbuv
凁	ialv
冾	irhr
冚	xusm
冐	ciwy
伻	enqk
佀	ebbo
佂	efpi
佹	exva
侹	emgy
俈	eplv
俓	eflp
倄	esew
偫	echh
檸	aira
傰	euww
僫	efkr
僲	epxa
儃	eawf
儌	edtt
儜	eira
儞	efks
儴	easg
兾	qvsk
鸞	bood
瀲	nrtp
粵	dgqh
挏	fcfl
鞏	peks
閩	dqcm
嶇	uhll
囌	lsvm
騁	wdhk
樞	ahll
幟	ukjk
嫻	cdau
矯	jmll
屢	blgc
鮭	vhht
匱	hljj
罌	jjjf
餡	kxdi
謬	bvvc
儉	erqr
磯	vnnr
濾	nuvr
攏	fkwu
鋭	tqlw
踴	pbss
徠	calc
戩	fnnk
汱	nhqs
鑒	hgut
馭	wbom
滸	nbgg
闕	dqwx
馮	iwmr
鵠	pldn
饅	kjub
鯗	qovv
靉	cint
饑	knnr
檻	ahgu
轂	hfdc
衊	gusk
蘢	skwu
蓽	sjsa
蒔	sjhh
輒	dlei
壟	kwuh
篳	gjsa
贓	jkdh
傚	eakt
閡	dthm
詆	bkxk
鯨	vaiv
餃	kaks
嬪	cifj
貸	ekjb
槪	adnw
詫	bigx
諜	bsau
飫	kmys
賁	gsjb
綃	oiwy
冪	xsju
櫫	thja
摑	fwkf
愷	rufq
灔	ncso
擷	fhlj
瀏	nktm
銬	thhk
鰍	vmih
謗	baqt
鑼	tuoe
禱	jhyh
籲	grcj
櫥	amhh
屼	ulws
檥	aqgk
檮	ahyh
癇	mdwy
紺	osir
紿	onlv
縋	odoc
艫	uuvu
薌	skgp
讌	bsfi
轇	dvvc
轕	dsje
韙	jfpb
韜	budi
鬩	ddwr
鴃	dbre
鶦	jwdn
鶹	kvdn
鷅	padn
呇	nlvs
傪	ennc
咰	lwjr
婰	ccsk
崪	uarg
崳	urfm
崸	uvjb
嵷	ucrp
嶍	uvvd
嶰	uxsp
巎	uvjt
巠	flpg
帀	fuji
帉	ukmd
帋	kxuj
帓	ufmj
幏	uits
幝	ullg
幦	blku
幨	uxvb
幮	umhh
幱	udaq
庤	mhhc
庬	mfcp
廦	mblk
廧	mhrl
廯	mvqy
峮	ubgl
峬	unfs
峟	uewy
哣	lflq
媌	csvt
媓	cdjw
媔	csmn
媦	cvwy
嫙	ctgp
嫭	cugh
嫾	cqxa
嬁	cbfq
嬐	crqn
孆	cjjc
孮	kijs
岮	uinb
宼	iflc
寗	irgh
寳	ijxj
尌	hhcz
屓	bjbs
屗	bmhc
屴	usls
岇	ukaj
岝	ugub
岧	umlv
廵	lgyc
廽	wuig
弆	hnso
憱	raif
惵	rsau
惽	roxj
愓	rjfc
愩	rpjb
愭	rhnj
慃	rknv
慙	ddri
慻	rqoj
憖	ahri
憪	rdwy
憸	rrqx
惎	uriq
憹	rcsm
憺	rxvb
憻	rawf
憼	swlr
懢	rhgu
扗	fhts
抂	fjws
抐	fcre
抸	fgoz
挆	feau
惏	raau
悳	gjer
弉	dhso
怇	rhbo
弣	behc
弮	qobg
弶	baiv
彚	bxja
彛	bqks
彺	cjwc
徔	csoz
徤	cbag
徥	cjfp
徸	ckvl
怋	roxi
悧	rmmd
怘	jrig
怞	rdox
恅	rhnb
恈	rnpn
恏	ckri
恑	rxva
恟	rwsw
恲	rqso
悀	rbsy
悂	rnnh
婲	csen
諫	bawq
婜	hbcn
埬	hajr
埻	hakz
妠	ccre
妵	ckjw
姠	cdxn
埲	hoak
埱	hjib
姩	cgak
姴	fxmc
埣	harg
妉	cxwr
埀	mqni
垺	hukz
姸	cnng
垹	hdpf
垔	phtx
垏	hbak
坣	ihts
坢	hqak
妋	cofn
妅	cpgn
坒	nnht
塴	huww
墫	hqph
墯	reph
壗	hbfu
売	hxwr
壻	hypw
夅	takp
夘	xajx
夲	ogid
塜	hxft
堔	hxka
塉	hiiw
奱	booo
娿	palc
奿	rkcn
妀	ocni
堿	hkfl
堽	hufp
堥	kgth
墌	hmsi
娋	ciwy
噊	lkgl
噣	luwq
嘫	lwhi
嘄	ldau
嗼	lsjo
嗘	luno
嗂	lujf
喼	lxbr
喰	lksv
喕	lsmv
喍	lpna
喌	llnl
啺	ljfc
啳	lqoa
啩	lhhu
唭	luqv
唫	ltjv
唖	lllf
唋	lrfa
哰	lipn
哫	lpzv
圛	wuhg
墐	hsir
噿	lvvg
囨	wguw
圗	wngi
図	wisi
娏	cfcp
娕	calv
娞	cucn
娨	cjng
嚁	lvve
囩	wina
囥	waej
囒	lsdq
囋	lpwj
嚃	luno
絸	ojjs
絿	ofnk
稶	mklc
綋	oien
綌	okrl
絑	opka
絓	ohht
綆	ofjs
絤	opxs
絍	oemr
稸	manv
篐	gahu
籂	gkgu
簴	guik
簜	gnjc
竌	kejl
竬	kgqc
竮	kbqs
簈	gbgn
簀	ghjb
篹	gjoa
篲	gddb
篰	gklp
篟	gehw
篖	gmbl
箺	gojr
穖	mnnr
箤	garg
箚	grmd
筺	ghjk
竱	kdhc
竸	kjww
竼	gekd
笁	gpgz
笅	gssi
笩	geki
笶	gjiz
笿	gtlv
筣	gmmd
筪	ghvj
籊	gvve
籒	gflv
籗	gceh
籚	guvu
穬	mmsk
絊	oafi
紾	orcp
紼	obka
紷	orkb
紲	osis
紱	oebk
紌	ofos
糮	qhgu
糓	hfqm
粸	quqm
粩	qhnb
粛	bqka
粙	qdom
穽	iika
窉	ifcr
窐	ihht
窛	iflc
窴	igjk
竆	iqll
粔	qhbo
粏	qokd
籺	qgyi
籹	qcnm
籯	gtjb
籞	gcgj
籝	gtcn
簛	gudj
芓	skzo
綔	ofho
稡	marg
艅	urfa
艌	urkr
艑	uhce
艓	usau
艖	uqpg
艼	sado
芶	swna
舤	uekd
芿	segn
茩	sdfl
茪	silw
荈	sxak
荗	skkd
荾	snkt
舥	uobo
舝	blxa
莣	stri
膥	fkyr
腗	wdlj
腝	wsod
腡	wrky
腢	wvyy
膁	wqbk
膉	wqku
膰	wgqv
舏	lwjs
臇	weck
臋	bskr
臎	wvvg
臙	wsfi
臦	hhee
臿	mdiq
莕	salv
莵	sdwk
脺	warg
蒪	snhc
葘	slfv
葠	sebb
葽	spcn
蒘	sclf
蒠	sqri
蒦	sebo
蒶	sokm
葋	swwl
蓗	schz
蓡	snbb
蓧	seua
蓱	snqs
蓲	shll
蓷	sfeh
葍	sflv
葈	snla
菄	sajr
萐	sfbp
菆	slbo
菋	slfw
菍	srkr
菛	sdmo
萅	sxwj
萉	swob
萕	stki
萿	snls
萖	sdwr
萗	sijs
萚	sfba
萫	smjr
萲	sunb
萺	scij
腍	wrkr
脷	wmmd
綗	ockl
绬	ksco
繟	ollg
繣	obhf
繲	oxsp
繷	ocsm
纀	oeio
纒	ovvh
缿	jdfl
繓	ojlb
罆	jegj
罊	dwej
罋	akgj
罭	uklf
罸	ubhc
羋	suak
繗	oqxa
繑	omll
羜	qiad
緭	ovwy
緃	orrp
緈	ohqg
緐	gego
緖	ohjk
緟	omvl
緪	orff
緮	ogjt
繉	ojwi
縌	oqwo
縖	oidl
縤	ohos
縩	owjs
繀	oueh
繂	oang
羙	qihy
羳	qgqv
脮	wucn
胢	walv
肔	woey
肣	wrky
肬	wfoy
胇	wbka
胒	wbnb
胟	wemy
胿	whht
聬	lknv
脕	wxlw
脗	wwcl
脟	wuhc
脡	wmgy
脪	wseu
脭	wljw
肎	xwym
聨	lnns
翆	vvrg
耈	hnwl
翏	vvrc
翢	whlv
翤	lcvv
翲	pjvv
翶	diiv
翷	qxav
耉	hhlv
聧	lbfo
耛	dknl
耟	dkhb
耴	leie
聄	lrcp
聑	llee
聣	ldwr
稬	msod
珱	jncn
秷	mdzh
瀙	nkaj
濢	nvvg
濭	nshu
濳	npwj
濶	ndls
瀀	nvwt
瀌	nmib
瀠	niio
灻	hiht
瀡	npeo
瀤	naug
灗	nqaf
灠	nhgj
灡	nsdq
灢	nglg
濓	nkgk
濎	njdd
濌	mvnj
澲	niqk
澦	nkvj
澞	nulo
澕	nsns
澁	nppp
潻	nmrn
潶	nghs
潱	nhxq
潬	nllg
潕	ngsi
漡	ngjc
漝	nvvd
漌	nsir
滼	naak
灹	igxi
炂	ikna
牏	drfm
燂	ipjz
熈	ghoi
熗	irkl
熚	ijsa
熰	ihll
熽	ibdf
熿	isdk
燇	iqph
炄	ibch
爎	iioi
爢	muib
爤	isdq
爮	uwos
爯	ucht
牅	dmbw
熅	iwru
熂	igqm
熁	issw
煷	iaej
煰	illl
煝	ibjm
煛	jjih
焿	imbr
焼	igsl
焫	iscr
焒	illv
焏	klbi
焎	fdib
烻	igpg
炲	inlv
炞	iaub
炐	idfh
滫	neuw
滝	nkdd
滖	nafg
洔	nhhc
泿	nggs
洂	ntys
洃	neih
洈	nxva
洏	nsrs
洓	nack
洠	nnpn
滀	nanv
洦	nvjr
洬	nefx
洷	ndzs
浀	ncso
浂	nqod
浉	nqfu
泑	nnsl
泇	nslv
泀	nyfl
沝	nnss
沗	fons
汘	nmqs
汑	ngxi
氹	ynsi
氜	gjrq
氎	vvvm
氋	sxfm
氊	mawf
氁	msjo
毨	mpwr
毢	mpxm
毜	mivm
毚	xlnk
浛	nrkl
浨	niau
浫	nxkn
渳	nble
溹	ngxo
溳	nljb
溨	ngka
溌	nbiw
湻	najr
湸	naej
湶	ndns
湵	nqxk
湨	njhq
湦	njps
湥	nihq
湢	nflv
湙	ntod
渿	najs
渒	ndgi
浲	ntdf
渃	nsel
渀	nogs
淾	tnsj
淲	nuhs
淧	nirg
淟	ncsk
淕	nhkh
涹	nmcn
涊	nmkr
涀	njjs
浺	nrlu
浶	nipn
浵	nwac
浳	nkwy
牎	dwcr
牑	dhce
秱	mcfl
睘	uflg
盳	jtwm
盿	jtem
眒	jdsm
眕	jrcp
眪	jfcr
睗	jjwc
睧	jkxj
矒	jsuj
睭	jwhl
睵	jgkl
瞂	dgjk
瞕	jkjz
瞖	hjej
矂	jlla
盬	hgju
盠	etum
盙	numf
皼	hxfb
皹	bxdc
皬	dceh
皩	djjl
皢	dhhl
皡	ddig
皟	dhjb
皍	dnaj
皉	dpnb
皅	dobb
癓	mcfe
癁	mcgt
瘏	mhjr
瘈	mdmo
矑	juvu
矹	vlws
牰	pdon
礳	vmvs
磪	vueh
磵	vdjr
礇	vdqo
礈	vqto
礠	vqnr
礱	kwuv
祡	pnjs
砈	vvaj
禒	jets
禠	jduh
禫	jpjz
禰	jfks
秄	mkzh
秪	mkxk
磩	vkji
磟	vvvc
磓	vdoc
磎	vuno
磆	vrgs
磄	vmbl
碽	vpjb
碅	vwmh
硾	vmso
硽	vodd
硺	vtkd
硲	vkrl
砱	vrkb
砞	vfms
砕	vrgi
砓	vess
砐	vgkd
瘄	msjr
痷	modd
痁	mulv
珳	jtcp
獘	qukh
獧	hufg
玐	jkaw
珆	jnlv
珘	juow
蔁	skjz
珶	jqbg
疿	mbka
珻	jgem
琀	jrkl
琁	jgyp
琑	jiwy
琒	jtdf
琖	jkkg
獑	hddj
獀	hdub
猻	hkgo
猭	hets
猤	hbfo
猟	hnea
猐	hqei
猄	haiv
狿	hgpg
狧	hlsq
狥	hwjr
狊	jhqm
犿	haub
犦	pjsn
犗	pidl
犃	pklv
牶	qopn
琹	jjau
琻	jtjw
瑃	jojr
甛	sils
疻	mlka
疺	mgoz
疄	vqxa
畽	vmvl
畳	vxjq
畧	vtlv
畟	vktp
畖	vugt
畓	nvts
畒	avre
畐	flvt
甽	vlct
甴	ljvv
甞	isir
甒	gsfr
瑔	jdns
甀	msrw
瓵	nlrw
瓲	rxwk
瓰	rkmd
瓧	rgiw
瓉	jooj
璓	jsmg
璑	jgsi
璅	jlja
瑿	hjek
瑹	jsra
瑵	jbkq
瑲	jrkl
瑫	judi
蓸	ssjj
譺	bnjp
蔂	svos
雺	ckgp
雃	fseh
隮	paqi
隟	plja
隌	pkjr
隃	prfm
陼	phjr
陙	pmcf
陒	pxva
陊	pxxx
阾	prkb
阸	phyi
阰	pnnb
阧	pigi
阞	pslf
闣	divt
闠	dljj
闟	drvv
闑	dqau
闁	ddmm
閴	djbm
閕	dhym
镼	ubww
镸	uc
铻	ofbl
钄	tsdq
钃	tbnq
鑙	tmfj
雫	cjxy
霔	cnkj
鐦	tdfs
霘	cncl
頍	gbvj
頋	vavj
韽	rkyj
韹	kjdj
韱	rrkf
韰	uxbf
韝	bsch
韗	bxdc
韔	bucw
韒	biwy
韈	ssuk
韇	shuj
鞿	snnr
鞽	smll
鞱	sudi
鞖	sucn
鞁	sbpg
鞀	smlv
靾	ssig
靷	sbus
靮	swkd
靤	swos
靏	cxed
靎	ctdn
霳	cptp
霢	cwdg
霟	cnsk
鑗	tmwn
鐥	tqql
頼	alvj
錴	thkh
錣	tbbb
錛	togs
錑	thhq
錍	tdgi
錀	trfc
鋱	tkri
鋩	tstw
鋀	tflq
銯	tosj
銭	tikg
銫	txob
銧	tilw
銡	thlv
銞	wjtj
銛	tlsj
銒	tnng
銉	tbak
銈	thht
鉨	txiv
鉣	thna
鉝	tklj
鉖	ttir
鉒	tkjw
鉋	twos
鉂	tlsi
鈰	tauj
鈢	tauj
錪	tcsk
錹	tpwy
鐣	tifs
鍂	ttjj
鐖	tnnr
鐌	txlt
鐋	tnjc
鏿	tiau
鏼	tgac
鏺	tbbe
鏨	ddtj
鏧	hbet
鏑	taqj
鏏	tddb
鏌	tsjo
鎿	trfs
鎼	tufs
鎻	tljb
鎭	tnjk
鎡	tqnn
鎞	tdsn
鎒	tmhc
鎅	tvrk
鎃	tndg
鍺	thjr
鍭	tebj
鍧	twby
鍞	tujb
鍗	taqu
鍑	tgjt
鍈	tsco
頪	qvjb
顋	vrvj
鈊	trij
鸇	awld
鷭	gqvd
鷪	jjxd
鷨	snsd
鷙	hqgd
鷖	hjed
鷍	qadn
鶱	iskd
鶪	jhdn
鶣	hcdn
鶚	llfd
鶂	dwdn
鵻	dehn
鵣	aldn
鵕	nktd
鵔	dnkt
鵆	cdic
鴺	obdn
鴜	pndn
鳰	bdnu
鲪	xbgl
鲏	xbpv
鱾	xoiv
鱻	vvvv
鱮	vdhk
鱦	vgmv
鱤	vkfr
鱣	vawf
鷾	kjrd
鸜	jjed
鰞	vdwv
鸻	cimn
覑	djjp
龥	rcvj
龞	qukg
龏	kwus
齼	paap
齸	pqku
齰	psjr
齫	pwau
齃	qvle
鼖	gshb
黿	flgm
黷	ghuj
黶	vjwg
黳	hjeg
黰	ggjk
黬	gkfl
黫	gpht
黣	ggem
黚	gsir
黓	gkih
黋	ilsk
麷	atuq
麳	atal
麞	mkjz
麛	mble
麏	mbgl
鹒	mbrm
鱆	vkjz
鯻	valm
顕	jivj
騣	wswt
騏	wuqm
駾	wqlw
駷	walv
駏	whbo
駊	wbpm
駆	whsi
馻	wnwr
馺	wgkd
饛	ksxt
饏	yltk
饎	khlv
饇	khll
餶	krgs
餳	kjfc
餧	kmcn
飵	kgub
飮	kxqs
飤	kres
飇	ehhh
飁	vvde
颿	wefm
颻	ujef
颸	evri
颴	egyp
顨	vjvl
顦	eivj
顚	njej
騜	wdjw
騼	wmlm
鯳	vmkk
騽	wvvd
鯮	vijs
鯟	vajr
鯘	vmcn
鯓	vqsv
殰	fxhj
鮽	vrfa
鮞	vsrv
鮋	vdov
魺	valv
魵	vkmd
魫	vxwr
魤	venb
魒	dpjs
鬰	assc
鬝	udjr
鬔	utdo
髾	uiwy
髸	uska
髱	uwos
髗	ruvu
髐	rhhl
骿	rqso
骪	rekd
骩	rrjg
驔	wpjz
驑	wlhv
驈	wkgl
鈖	tkmd
鈆	tkna
蔃	sblq
裶	xufy
裬	xhkt
裧	xiih
裦	akfg
袹	xvjr
袸	xeuk
袨	xana
袙	xdby
袔	xalv
袌	awog
衼	xgbo
衸	xrka
衜	cqqi
衇	gudg
衂	gumk
蠵	quel
蠭	tdoq
蠥	wdkq
蠝	qvvv
蠐	qaqi
蠁	kgkq
蟺	qawf
蟩	qvqx
蟧	qiis
蟤	qook
蟐	qiuj
蟉	qvvc
蟇	sjoq
裲	xfub
褄	xgbc
螿	dwhq
褌	xxdc
訿	bpnb
訽	bwlv
訹	bakd
訷	bdsy
訰	bxwk
訒	bmkd
訆	bwjy
觙	xsgk
觘	xsig
觗	xskx
觓	xswj
覶	ubcj
覭	xjaj
覟	hrjj
覝	nijj
覂	pgoz
襭	xhlj
襫	xovj
襙	xlla
襗	xuhg
襒	xqut
襐	xxlt
襏	xbbe
襉	xdwy
襇	xdjr
褹	xhkk
褑	xunb
蟂	qdau
螥	qrkl
詉	bcbo
虣	fkpu
蘶	smcd
蘠	sdhl
蘜	sswq
蘙	shjv
蘁	sjll
藾	salj
藰	sktm
藭	siqb
藦	smfs
藢	scfj
藞	svvv
藒	smje
藎	sbfu
藀	siii
薡	sjdd
薠	sivj
薝	sxvb
蕼	suba
蕸	sbio
蕳	sdjr
蕍	snrm
蔳	snhw
蔰	shlo
蔯	spaj
蔩	sifk
蔛	sxsg
蔎	sbes
虁	svjt
蚏	qwyc
螜	hfqc
蚐	qwir
螌	ueqc
螉	qknv
螁	qgoc
蝹	qjum
蝢	qvjb
蝚	qkga
蝑	qypw
蝐	qcij
蝏	qaad
蜹	qscr
蜫	qjnn
蜧	qhhq
蜛	qbjg
蜙	qakn
蜏	qmgn
蛷	qfnk
蛯	qhnb
蛧	qcss
蛢	qqso
蛠	qsss
蛝	qggc
蚾	qbpc
蚼	qwlv
蚻	aeqc
蚲	qnqk
蚭	qbnb
蚢	qaej
詅	brkb
詋	blwr
鈄	tigi
轖	dhrl
輨	dibb
輈	duoc
軽	dbht
軰	qndc
軯	dnqk
軭	dhjw
軝	dkxi
軚	dokd
軑	dodc
軂	qiis
躻	qipg
躟	pasg
躆	puts
躀	pegj
蹨	pwhi
蹥	pdoc
蹞	pnvj
踾	pflv
踲	pdgj
踋	phna
踈	palv
踄	ppiv
踁	pflp
跿	phzz
跧	prjw
跠	pobg
跒	palv
轐	diqo
轗	dkfr
趩	hvsk
轚	dwed
釼	tmkd
釹	tcnj
釳	tgyi
釪	tfhc
釨	tkzj
釚	trjj
釃	pfcm
醼	psfi
醓	pxwu
醏	phjr
酼	panw
酨	gkpy
酘	pesy
鄽	mvkp
鄟	dhpf
鄐	anvp
郟	orrp
郔	gpgp
郆	hlpf
郀	ofhp
邌	mwgo
遻	llqo
遖	gcqo
迯	xuoc
迀	nocg
辡	kkxx
轛	diqh
跊	pfwz
趧	hjfp
詏	bnsl
豜	tfso
豃	krlt
豂	krlc
谽	krll
讜	bigh
譶	bbby
譲	bakg
譭	bdpe
譤	bdtt
譠	bawf
譙	beib
譖	bhwj
譄	bqjj
謻	bmxx
謺	hqgb
謶	bmsi
謮	bhjb
謥	bdtr
謚	bqku
謖	bvkt
謌	ball
謈	jskb
諌	bajr
諉	bmcn
誝	brkl
誁	bqso
誀	bley
詒	bnlv
豙	ktsl
豯	tuno
趦	hixl
豴	taqj
趥	hqpy
趞	hsjr
趖	hrrh
趌	hhlv
趉	hwwk
趈	hulv
趂	hxiv
赾	hdjz
赮	hkkb
赬	hkkj
贚	jkwu
贑	kjpj
贍	jxvb
贂	jnnc
賶	jrkl
賳	jgkl
賥	jarg
賟	jcsk
賛	oojb
賚	ajbl
賙	jwhl
賐	jnkt
賎	jikg
貹	jpsb
貭	dgjb
貜	vjjb
豶	tgsj
殱	fxgf
弚	qbus
殬	fxug
劽	fxms
卪	akdj
卥	uwck
卙	uegi
卌	ss
卂	ygii
匬	hrfm
匫	hwcj
匢	hwcp
勄	gesl
劯	vsls
凪	epij
劮	gosl
劦	sssl
劥	aesl
劚	bnum
剱	rrmk
剨	dvmd
剗	kkmd
刢	rkbm
刋	mmdq
厑	vlnb
厫	vhwt
厰	vitp
厳	nvyt
啒	lbww
啇	aqcj
啂	luke
唜	flnb
唙	lhih
唓	ldcv
唈	llob
哤	lfcp
咍	lnlv
呹	lgof
呮	llka
呩	ljsv
呝	lhyi
呏	lgso
呄	gjgn
吺	lesv
叿	lpgv
叏	bubo
叄	nnnl
凴	iwej
冞	xqmm
娧	cqlw
俌	enfr
偢	emih
偛	emdi
偍	ejfp
偆	eojr
偄	esod
倸	euau
倛	euqr
俧	ehri
俤	eqbg
俋	elob
冘	xwrm
俉	efbl
侾	ehkz
侻	eqlw
侰	ebgl
侭	ebki
価	epxr
侚	ewjr
侊	eilw
侅	ethr
偤	eqpy
偭	esmr
偹	eutv
傇	esle
兺	kmln
儹	epwj
儳	exlk
儩	ejjc
儥	ehuj
儣	emsk
儊	eaap
僿	eish
僸	eaaj
僪	ekgl
僠	egqv
僒	eibl
傸	eoss
傮	esjj
傤	egkx
傡	ekkl
傟	eknv
傗	eanv
傎	egjk
啘	lixa
喐	lewp
喗	lxdc
塂	hsko
墣	hiqo
墝	hhhl
墑	haqj
墎	hakp
塺	mhta
塤	hljb
塟	sfxh
塐	hhos
塅	hele
堩	hrff
喠	lmvl
堄	hdwr
埾	lbht
埦	hixa
埞	hifp
埊	unht
埆	hxsy
垿	hmky
垼	ceht
垪	hqso
墪	akth
墿	huhg
壏	hhgu
壒	hshu
姺	cpwr
姈	crkb
姅	cqak
妿	slcn
妱	cmlv
妏	cten
奲	ohjg
奩	ohll
奀	godu
夿	oobd
夰	okad
夞	xuln
夈	tqmp
夀	hylh
壾	hhbo
壱	hxnb
壥	hvgh
壣	hlnw
壙	hmsk
垉	hwos
坲	hbka
坱	hcod
噳	lulo
噧	lsvy
噡	lxvb
噟	meel
噒	lqxa
噄	ldmo
嘺	lmll
嘳	lljj
嘙	lnbc
嘕	lfpi
嘒	lddb
嘑	lugh
嘇	lnnc
嗴	lqen
嗊	lpjb
嗈	lllo
喺	lego
喸	nlnb
喩	lbfl
喡	lbwv
噮	lufg
嚊	lqvl
坔	nhts
嚍	lbfu
坄	hest
圸	hust
圷	hjxt
圲	hmqt
圠	heit
圌	wusr
囸	wfpi
囬	wuir
囦	wnsw
囘	cosk
囕	lhgj
嚽	lhwj
嚺	luqo
嚹	ljuh
嚸	lgul
嚩	lonh
嚤	lmfs
嚡	lshh
嚟	lmwn
佮	erhr
佡	erus
佒	ecod
櫛	agba
鈾	tdoj
鍘	tjmd
閔	dtem
餛	kjnn
駢	wqso
儔	ehyh
塋	iixh
嬏	cgqv
幗	uwkf
礪	vvsv
鎊	taqt
筧	gjjz
翬	vvxd
諢	bxdc
銃	tanw
鑠	tdna
颶	ejka
餾	kkvt
髖	risk
鷴	dadn
鈸	tebk
躓	pddj
賑	jmcb
詣	bnjr
鸝	fcfd
侖	rfce
嚙	lpcv
燁	isns
綰	oibb
綾	ohkt
縟	omhc
覲	sijj
諍	bxby
諛	bdre
鉀	tvjj
錚	txby
鱔	vqql
圇	wrfc
燾	hypi
琺	jnhn
簫	gbdf
蘚	svqy
詡	bvvx
歿	fxwb
僉	rq
儐	eifj
罏	juvu
臠	boor
詼	beih
酈	fcfp
醱	pbbe
錠	tifp
鎢	tdwj
鎬	tagj
鏇	ttgp
閏	djwm
闥	dhqo
顥	jaij
騅	wehm
驤	wasg
鰥	vuns
鳧	dejn
鴇	ngdn
麩	atof
黌	dssk
殣	fxsi
臏	wifj
繒	oqjj
壆	dssh
縵	ojub
嶗	uiis
廡	mgsi
惲	rxdc
愾	rgqm
擫	fvjh
曄	jsns
梫	abxb
橚	abdf
檉	allj
欞	aclr
漚	nhll
瀦	nthj
灃	nudq
焢	iipg
硤	vorr
碭	vjfc
綩	oixa
綬	ouxb
緇	olvt
飴	knlv
鎂	tqod
佌	epnb
〇	lv
乚	ei
乕	diuj
乑	ecir
乆	erei
丵	iqgi
丆	vs
丂	hk
軎	dlvc
勹	wb
㨃	fakz
鋐	tien
軲	djgc
躥	pidb
繮	ofvf
玅	anig
嬡	cuxt
診	brcp
旣	dnhw
瘧	mubj
襖	xdqo
乣	neia
乵	keix
乸	oeme
乹	gjei
佊	ebpr
伿	elka
伳	esir
伨	ewir
伌	evaj
伂	efuj
伀	ekna
仯	eigp
仒	rire
仐	rgie
仌	rree
亼	rfie
亴	ahrj
亱	aejf
亜	llfi
亐	ieir
亀	xjdd
乿	uoei
乻	triy
蝸	qrkc
壩	hcsw
鷗	hlld
槳	dwha
閹	dodd
葷	sxdc
闈	dbwm
龔	kwuk
獷	hmsk
綸	orfc
閭	dllv
驍	whhl
跥	pgau
擄	fuvs
薈	srfj
蛺	qorr
諭	brfm
韃	shqo
騾	wvos
磧	vhjb
紉	omkd
絀	owwk
誹	bufy
鉻	ttlv
錮	twjg
氫	gflp
鄒	wwwp
鹼	urql
鵲	sjdn
醞	pwru
齦	pggc
藺	sdeh
疇	vhyh
銲	tjng
頡	hlvj
鍍	tmsb
顎	llfj
驪	wfcm
鴣	jdng
摋	fsae
檜	arfj
謁	bjwe
饜	vjwk
嘰	lnnr
潁	nnvj
躊	phyh
娔	cjwr
伅	exwk
娪	cfbl
斪	wldj
旜	tgaf
旚	tgpj
旕	trin
旓	tgiw
旐	tgwi
旊	tgrw
旇	tgbp
斿	tgkz
斸	bnud
斣	uwqg
攨	fiuu
斢	sdkg
斊	tlee
敽	mlcb
敺	hllb
敯	oxjb
敪	bbbt
敤	jaub
敀	dtpb
攺	otps
旼	jter
昁	jfuj
昛	jhbo
昦	joka
曣	jsfi
曘	jcsr
曏	jkgp
曅	jsns
暿	jhlv
暽	jqxa
暷	jdhc
暶	jtgp
暭	jdig
暣	jgqm
暙	jojr
暒	jjps
暁	jgsl
晵	htjr
晑	jdxr
晍	jcfl
晀	jwii
昷	jumr
昲	jbka
攱	kgbo
攡	ftwe
挩	fklw
揃	fqwm
揼	fvns
揻	fkfc
揰	fmvl
揨	faad
揥	faqu
揟	fypw
揗	fdgj
揋	fvhf
揇	fgcg
揁	fujb
攟	fmwm
掱	fffs
掦	fjwc
掜	fdwr
捹	fogs
捬	fmeh
捝	fqlw
捖	fifl
捈	frfa
挳	fflp
搎	fkgo
搘	fhnj
搼	fqof
摓	ftdo
攓	fisp
攐	fisg
擧	dhjf
擖	fsje
擕	feck
擑	fllk
撳	ftxq
撯	fqjm
撟	fmll
撏	fbph
撊	fdwy
撆	qukf
摾	fblq
摵	fkji
摲	fddj
摦	fofu
摝	fmls
摜	fegj
摕	fsfu
曤	jceh
曨	jkwu
曫	booj
樐	aulu
檘	ablk
橬	ahwj
橑	aoqi
橏	aqql
樳	abph
樤	aeua
樠	asfb
樖	raal
樔	alja
樏	avos
曱	jusr
樇	aeuw
樃	akbw
槸	ahkk
槷	hkha
槴	ahlo
槰	atdo
槯	aueh
槥	addb
槜	aegn
檟	apjb
檶	aohl
櫄	amgh
櫋	aqit
殠	fxqh
殜	fxsa
殑	fxjw
殀	fxmy
歽	fxdj
歒	aqcx
歅	phxq
歁	uexq
欯	hlxq
欪	wwxq
欝	assh
欛	acsw
欔	ajjb
欑	apwj
欅	adhf
櫿	aiil
櫝	ahuj
櫑	avvv
櫍	addj
槕	auja
槒	aanv
槑	lala
桗	agau
栕	aheu
柹	ageg
柦	ajfi
柗	aklv
柕	akgp
枿	agso
枺	afmu
枠	argi
枛	auzu
杹	aenb
娬	cfkp
杛	abgu
杗	tauw
杁	abuu
朸	aslu
朳	akau
朞	uwyq
曺	fdjr
曶	wcjr
栥	ixau
桱	aflp
榡	ahos
梀	aalv
榟	aikx
楪	asau
楘	kgta
楌	akgc
楃	abdz
椼	acni
椵	abib
椙	ajjr
椗	aifp
棷	albo
棶	aalu
棅	ambj
梲	aklw
梬	adhk
梩	avlu
梠	allv
梐	annh
梌	arfa
梈	aake
挮	fqbg
杤	afwb
挅	fgau
嶎	ubjh
帠	duji
帊	uobj
巏	usle
巋	udpu
巄	ukwu
巁	uvsv
嶱	usje
嶯	ullk
嶣	ueib
嶕	ueib
嶐	uptp
嵲	uqau
帾	uhjr
嵥	uxaa
嵤	iixu
嵓	ulll
崺	utgo
崏	ukxj
崋	unso
峼	uplv
峺	ufjs
峹	rfau
峷	ukxs
峱	hbus
帤	cluj
幈	ubqs
徖	cijs
弿	iskb
徍	chht
彾	crkb
彸	ckna
彵	coec
彴	cwkd
彯	pjcp
彮	irlc
彨	fccc
彜	eqks
彄	bhll
彃	bjsa
弅	kmso
幐	wqou
廱	mlle
廘	mmlg
廃	mbiw
廀	miib
庿	msvt
庒	mhkd
庁	madg
幩	ugsj
幤	ituj
幚	dpdu
幑	cfuj
峞	uxva
峛	ufxm
峘	ufjf
嫟	chsl
孊	cmuf
孈	cuel
嬺	chsr
嬹	cdck
嬟	cqgk
嬜	kjxc
嬚	cmqk
嬔	cxlp
嬇	cljj
嬀	cugw
嫮	ccfh
嫐	cvsc
峗	uxva
嫆	cirl
媱	cujf
媝	micn
媃	ckga
媂	caqu
婻	cgcg
婸	cjfc
婤	cwhl
婖	cfok
婐	cjau
婍	coal
孨	kkkz
孲	kfka
宨	iwii
宯	ihkz
峑	urjw
峏	usrs
峅	unso
岶	udbs
岏	uflw
拸	fxxx
岊	ousb
岉	uwcp
岆	umys
屶	umds
屪	bioi
屖	bkxs
屔	dfbn
尶	lhgu
尯	fxva
尩	kwjw
尦	kwwk
尣	kwra
専	fdhc
尀	hlhc
寜	iruy
寊	iujb
宻	ibqu
徎	cljw
幜	ujai
愯	rebo
懚	rupr
憉	rhcp
憏	rwjs
憣	rgqv
憰	rkgl
憿	rdtt
懅	ruts
懍	rawm
懎	rhrl
懓	ruxt
懜	rsux
慁	wtri
懠	raqi
恔	raks
恊	rsss
恉	rnjr
懧	rira
懬	msdr
懯	nttr
懻	rqnk
戁	sflr
慏	rxjk
慀	runo
戓	klvg
悪	llfr
愇	rbwx
惿	rjfp
惾	rswt
惸	rwjk
惥	drri
惤	rban
惗	rrkr
惖	jwcr
悷	rhhq
悜	rljw
愥	rsco
悏	rorr
婂	cduj
悎	rplv
悋	rtlv
恵	fdri
恱	rknw
愗	kgtr
愘	ritl
恦	rdxx
戉	keig
愅	rsgx
戞	vwxk
忦	rrka
徢	cfbp
徦	cbib
忕	rodx
戣	bfok
拲	skfs
拰	femr
拕	finb
抪	feuj
抍	fgso
忣	rgkd
拫	fggs
忩	knri
払	fnas
怣	gori
抇	fjrs
扱	fgkd
扡	foes
扚	fwkd
戹	hyih
戻	hodh
忷	rswk
扏	frjs
裍	xwau
裄	xcic
裃	xjjx
袾	xpka
蠘	qgke
袶	xtak
袻	xsry
蠚	selq
蠞	gbnq
蠦	quvu
袳	xxxx
蠩	qbhj
裗	xanw
蠫	vmqq
裑	xqsy
褈	xmvl
裚	fdag
誾	dbym
誯	bjjr
誵	bsew
蠌	quhg
蠑	qiia
蠒	fkuq
誺	baly
蠗	qvve
袰	eagy
裞	xqlw
裻	jibg
裺	xodd
裷	xqoa
裮	xjjr
裫	xddf
裪	xwjf
裠	bglg
袲	axxg
袉	xinb
袯	xwbk
諅	ubyq
蠬	qkwu
蠮	qhjv
蠯	mdgq
蠰	qasg
衉	gutl
諃	baau
蠳	qjjc
蠴	qsuj
衐	chbi
蠷	qjje
蠽	iekq
誮	bsen
蠾	qbnq
衃	gugu
衈	gule
諆	buqy
衋	bavu
衑	crki
諁	bbbb
袎	xnsl
袬	anlg
袩	xulv
袧	xwlv
袣	xsiy
袡	xcht
袟	xgof
袕	xixy
袀	xwir
衟	clvi
衻	xcir
衶	xlus
衴	xxwr
衳	xkna
衯	xkmd
衧	xfhc
衦	xngy
訲	blus
褜	wwog
誫	bmcy
詘	bwwk
觩	xsfk
觨	xspn
觢	dmxs
觠	qoxs
觛	xsjf
觃	ckzj
覿	hujj
覾	igqj
覹	jcfe
覵	dwjj
詓	bhna
詗	bclv
詙	bebk
詊	bqak
詚	bjfi
覴	bflj
覱	ddjj
覯	schj
覫	aqxj
覨	llfj
覡	prrj
覞	jjjj
覛	dgjj
覘	uljj
覕	rgjj
覒	mjjm
觪	xskx
詇	bcod
誢	bjjy
訅	brjy
訮	bfso
訬	bigp
訩	bswk
訨	bpiy
訦	bxwr
訤	bssi
訡	brky
訠	bbus
訜	bkmd
訙	brkd
訍	bbkd
訋	bwkd
訁	by
觬	xsdw
訵	bwwr
詀	bulv
詂	behc
詃	bana
觾	xssi
觻	xsda
觷	dsss
觶	xslg
觵	xssk
觲	xsqp
觰	xshj
觮	xsbn
覐	jssi
覎	jkzj
覉	psol
褨	xqpg
襀	xhjb
褿	xsjj
褼	xpoo
詶	bnlc
詸	bqmy
詻	btlv
詽	bnng
詿	bhht
誈	bdzy
褺	hqgg
褮	iixg
褬	xbba
褤	xhlg
覄	pehq
褣	xirl
褠	xsch
褝	xqjg
訯	bgkd
褗	xhjc
褖	xets
褏	akfg
褎	akfg
褋	xsau
誏	bkgg
誛	bbxb
誟	bhkz
襃	akfg
襊	xjlb
襋	xacc
襍	xeau
襽	xsdq
襼	xshn
詜	bwbo
蠇	qsvy
詤	brew
詪	bggy
詯	bqiy
詴	bewy
詵	bpwr
襺	xscq
襹	xfcm
襸	xpwj
襷	xdhf
襵	xlll
襱	xkwu
襰	xalj
襮	xjsn
襧	xfks
襣	xqvl
襡	xuwq
襝	xrqy
襔	xsfb
襓	xhhl
襑	xbph
襎	xgqv
蠉	qufg
螎	qflu
蠆	svqc
蚅	qvaj
虸	qkzc
虶	qfhc
虴	qgxi
虳	qwkd
虲	qubc
虭	qmdc
虪	ueug
虨	uaac
虦	kkuh
虥	ukkg
虤	uuhh
虠	aksu
虝	uwcp
虘	ujqh
虗	udfi
虋	sdcm
虊	sboa
虉	sfld
虈	slll
虄	sqtp
虃	snrf
蚄	qtfc
蚈	qfso
蠄	qrtn
藔	sioi
蛌	qugc
蛈	qgof
蛅	qulv
蛃	qfcr
蛂	qebk
蚽	qgfi
蚸	qdkd
蚷	qhbo
蚳	qkxk
蚫	qwos
蚦	qcir
蚥	qksi
蚟	qjwc
蚞	qauc
蚛	qlus
蚚	qdjc
蚙	qrky
蚘	qfoc
蚗	qbre
蚒	qwat
蚉	tqce
虂	scpl
蘾	shag
蘽	svva
蘻	sdwo
蘉	suxb
蘈	smej
蘃	sppa
蘂	srra
蘀	sfug
藽	skaj
藼	sidr
藸	sthj
藶	svmp
藵	selg
藲	sahl
藱	smdg
藯	sbjr
藮	saei
藬	splj
藧	soub
藣	sunn
藡	saqo
藙	skte
藖	shbj
諊	bwqm
蘌	scgj
蘍	smgs
蘎	scwo
蘨	sujo
蘺	stwe
蘵	slkk
蘴	sudq
蘳	ssdh
蘲	svvh
蘱	sqhj
蘰	sojb
蘮	suvm
蘬	sdpu
蘦	scll
蘏	snjj
蘥	srce
蘣	ssdj
蘟	spur
蘞	srtp
蘝	srxq
蘕	soto
蘔	snmj
蘓	smvv
蘒	smxd
蛍	nxqc
蛒	qtlv
蛕	qewy
蝷	qmqw
螴	pajq
螱	bjhq
螰	qmlc
螮	qsfu
螪	qaql
螩	qeua
螧	qhnj
螤	tqjr
螡	tqqc
螠	qqku
螛	qidl
螚	nwnq
螙	aqqc
螖	qrgc
螕	qdsn
螔	qduh
螒	gjrq
螑	qqhq
螏	qmji
螊	qqbk
螇	quno
螷	mdgq
螸	krlq
螹	qddj
蟡	qugw
蠀	qixj
蟿	dweq
蟽	qhqo
蟼	swlq
蟵	qvfh
蟴	udqc
蟱	qgsi
蟰	qbdf
蟣	qnnr
蟝	qnha
螼	qsir
蟚	hcqc
蟙	qkjk
蟘	qekj
蟖	qudj
蟔	qghc
蟍	qmma
蟈	qwkf
蟅	qmsi
蟃	qjub
蝿	qjdd
蝵	miqc
蛗	dqcd
蝳	qhem
蜬	qynw
蜦	qrfc
蜤	adqc
蜠	qwmh
蜟	qanw
蜝	uqcq
蜖	qwui
蜔	qwvt
蜐	qhns
蜌	qnnh
蛿	qrkl
蛽	qjbc
蛵	qflp
蛬	skqc
蛫	qxva
蛪	dmqc
蛨	qvjr
蛥	qxxx
蛡	qvvx
蛜	qebg
蛚	qfxm
蜭	qxdi
蜯	qoak
蜰	woqc
蝔	qnnd
蝬	qswt
蝫	qhjr
蝩	qmvl
蝧	qsco
蝞	qbjm
蝝	qets
蝛	qkfc
蝘	qhjc
蝖	qiff
蝒	qsmc
蜳	qakz
蝋	qnea
蝊	qifp
蝆	qsak
蝅	fofq
蝄	qcqt
蜽	qfub
蜸	hbqc
蜶	qarg
蜵	qddf
諈	bmso
輜	dlvt
諎	bsjr
躼	qucs
軣	diir
軡	drky
軠	dmrc
軞	dmmc
軜	dcre
軙	dubo
軘	dxwk
軗	desc
軖	djwc
軕	dusc
軓	dekd
軐	dygi
軉	qijj
軈	qmer
軇	qhyh
軆	qcsq
軅	qvee
軄	qkjk
軁	qlgc
躿	qmbn
躾	qqod
軤	dgqh
軧	dkxk
軩	dnlv
輆	dthc
輖	dwhl
輑	dbgl
輐	difl
輏	dpyc
輎	diwy
輍	dkrl
輌	dfcu
輋	uodc
輇	drjw
輄	dilw
軬	nodc
輂	skdc
輁	dska
軺	dmlv
軹	dlka
軷	debk
軶	dhyi
軴	dkjw
軳	dwos
軮	dcod
躽	qhjc
躸	qoal
輙	dlbo
躷	qmcn
蹖	podi
蹔	ddpz
蹃	psel
踿	pmih
踻	prkz
踸	puei
踷	phjr
踭	pxby
踥	pkcn
踜	phkt
踙	plbo
踗	prkr
踕	pfbp
踓	pehz
踎	pglv
踍	phkz
踇	pgem
踃	piwy
跾	eutp
跲	prhz
跮	pdzz
蹗	pmlz
蹘	pvvc
蹛	psfu
躛	cblp
躶	qjau
躵	qmkr
躴	qkgg
躳	qllv
躰	qafi
躮	qkmd
躦	ppwj
躤	psdj
躢	pdjv
躚	ppoo
蹝	pcpp
躗	cbip
躖	pnnf
躒	pdna
躎	pfks
躌	pgsa
蹸	pqxa
蹵	aifp
蹮	ppoo
蹪	pljj
輘	dhkt
藌	sirq
跢	pxxx
迧	docs
遟	bkoc
遚	dubo
遌	llfo
遃	kgco
遀	epwo
逿	jfwo
逽	selo
逺	hego
逳	anwo
逰	fgko
逫	bbbo
逪	sjoc
逩	ogso
逨	aocl
逧	krlo
逜	fblo
逘	njoc
逇	hooc
迿	wjoc
迲	hnoc
迱	inoc
遤	wocm
遦	egjo
遧	kjoc
邞	opff
郠	fjsp
郘	llpf
郖	flqp
郒	kbno
郍	upfo
郌	hhlo
郋	qpfi
邼	hjpf
邫	dlob
邜	xpfx
遪	nnno
邚	cpfn
邖	upfs
邒	apfd
邎	wbgo
邍	tvbo
邆	bflo
遾	gpro
遳	srro
遬	alxo
迬	kjoc
迣	soci
輠	djau
迚	luoc
轌	dcbj
轋	ddoc
轊	dddb
轈	dlja
轃	domh
轁	dudi
輽	dnov
輺	dlfv
輷	dwby
輵	djwe
輴	ddgj
輲	dusr
輱	dkfl
輰	djfc
輬	daiv
輫	dufc
輧	dgnn
輥	djnn
輤	dhwy
輣	dwwy
輡	dxdi
轑	doqi
轔	dqxa
轙	dqgk
辬	ktkx
迗	fooc
迏	okoc
迋	jocw
迃	fhoc
辿	uocs
辸	gocn
辷	foci
辴	lljm
辳	aamc
辪	pdkx
轜	dcsr
辥	wdkx
辠	qkxi
辝	nlkx
轥	dsde
轤	duvu
轢	ddna
轠	dvvv
轞	dhgu
轝	dhjd
跭	ptak
跉	prkb
諐	elwb
譍	meeb
讆	cbib
讅	bigv
讂	bxct
譿	bddr
譾	bqwv
譼	hgub
譹	bats
譸	bhyh
譱	qbby
譫	bxvb
譩	bkjr
譨	bcsm
譧	bmqk
譥	dttb
譣	brqy
譢	bqto
譡	bivt
譝	bgmy
譛	booj
譗	bgrh
譕	bgsi
讈	bvmp
讉	bljo
讋	kwub
谻	krla
豛	tess
豓	uddu
豒	uddg
豑	csfg
豏	flqk
豍	flqg
豅	krlu
豄	krlj
谼	krlk
谸	mkrl
讍	bjll
谉	dids
讝	bllt
讛	bshn
讘	blll
讗	buel
讕	bdaq
讔	bpur
讑	brce
讏	cblb
譐	bqph
譌	bugw
豟	thyi
譋	bdwy
謆	bhvv
謃	bjps
諿	blle
諽	bsgy
諼	bunb
諻	bdjw
諹	bjfc
諵	bgcg
諬	mfby
諪	baad
諩	bqie
諨	bflv
諥	bmvl
諤	bllh
諣	brky
諞	bhce
諚	bifp
諙	bkxj
諘	bhgy
諗	brkr
諓	bkkg
謍	iixb
謏	bdub
謑	buno
謲	bnnc
譊	bhhl
譈	bakt
譇	bohj
譆	bhlv
譅	bmkp
譃	buie
謽	blqb
謼	bugh
謸	bhwt
謰	bdoc
謒	brkl
謯	bujq
謭	bqwm
謪	baql
謤	bpjs
謣	bcfh
謟	budi
謜	bvdi
謘	bbkx
謕	bduh
豞	twlv
豠	tjqs
跇	psiz
賯	jwjk
赺	hrky
赹	hwir
赲	hslz
赱	hqkd
贙	uujb
贘	jijb
贒	hluj
贎	jsvy
贋	veej
贉	jpjz
贆	jhhh
贄	hqgj
贃	jllr
贁	jjtp
賿	jvvc
賾	hhjb
賻	jnhc
賹	jqku
賵	jcij
賲	elaj
賱	jxdc
赻	higp
赼	hxqz
赽	hbre
趠	hujz
跀	pwyz
趻	prky
趶	pfhc
趲	hpwj
趰	hfks
趮	hlla
趭	heib
趪	hsdk
趢	hbns
趜	hwqm
赿	hkxi
趛	htjz
趚	halv
趓	heau
趒	hwii
趏	hlsz
趇	hklz
趆	hkxk
趃	hgof
趀	hgeg
賰	jojr
賫	grrj
豣	tnng
賩	jijs
貗	vlgc
貖	vqku
貕	vuno
貑	vbib
貈	vuoz
貇	vggz
貄	vbak
貃	vdbz
貁	vixz
貀	vwwk
豿	vwlv
豼	vnnb
豻	vngz
豵	tcrp
豱	tjum
豮	tgsc
豭	tbib
豩	ttss
豧	tnfs
豦	utsh
豥	tths
貚	vllg
貛	vsle
貟	njba
賉	jgum
賧	jiih
賝	jxka
賘	jmhk
賗	jllu
賕	jfnk
賔	ibjb
賏	jjbb
賌	tjbh
賋	jaks
賆	jqso
貤	joeb
賅	jthb
貾	jkxk
貺	jlwr
貵	nojb
貱	jbpb
貰	sjbi
貮	fkjb
貦	jflw
貥	jaej
藑	sxct
聮	lnni
藊	smhc
緰	orfm
緧	oqpy
緦	ovri
緥	oela
緢	osvt
緡	ooxj
緗	oajm
緕	otki
緔	oiss
緓	osco
緎	oklf
緍	okxj
緆	ojwc
緁	ofbp
緀	ogbc
綼	odgi
綶	ojau
綧	oakz
綥	ovlj
綤	mlpo
綡	oaiv
綞	omso
緫	owcr
緱	oebj
耼	lcir
緳	mdmo
縞	oags
縜	oljb
縚	oudi
縙	osle
縘	ouno
縔	obba
縓	ovdi
縒	oqpg
縎	orgs
縍	oaqt
縇	oiff
縅	okfc
縄	ojdd
縃	oypw
縀	obib
緿	onlr
緽	oujb
緸	opht
緷	oxdc
緶	oefs
緵	oswt
綛	omkr
綘	otdf
綕	ohri
綒	oukz
絋	omna
絉	oakd
絈	odbs
絇	owlv
紻	ocod
紸	okjw
紶	ohna
紴	obps
紭	obna
紪	opnb
紨	oehc
紑	ogus
紏	oigi
紎	ohqs
紃	olcs
糿	omds
糽	oads
糷	qsdq
糶	wwqe
糳	iqgq
糲	qvsv
絎	ocic
絒	onlc
絖	oilw
絴	oqys
綐	oqlw
綊	oorr
綈	oqbg
綇	opys
綂	oalw
絾	okyi
絽	ollv
絼	ovzs
絵	orin
絭	qoos
絗	owlv
絬	olss
絩	owii
絧	ocfl
絥	oehq
絣	oqso
絠	oewy
絟	orjw
絚	ofwf
絘	oixq
縥	oomh
縦	ocqp
縨	ojil
罧	uaau
羻	qmyt
羺	qcsr
羷	qrqy
羴	qqqy
羫	qipg
羪	qkgg
羦	qifl
羠	qobg
羛	qbka
羘	wqyy
羗	qena
羐	shxk
羍	oqyd
羉	uboo
羄	uouj
羂	uolw
羀	cssv
罿	ukvl
罻	ubjh
罺	ulja
罯	ukjr
翄	vvgb
翇	vvek
翈	vvvx
翿	hypv
耲	dkag
耯	dksb
耫	dkhj
耣	dkrc
耡	dkjs
耝	dkjq
耚	dkbp
耓	dkad
耂	ht
翸	gsjv
翉	afvv
翵	vvdn
翴	vvdo
翨	vvjp
翞	vvai
翗	xxvv
翓	hlvv
翑	vvwl
翐	vvgo
翋	vvkl
罬	ubbb
罦	uukz
縪	ojsa
罤	uqbg
繱	oswr
繰	olla
繬	ohrl
繨	ohqo
繧	ocin
繥	ohlv
繢	oljj
繠	rrro
繝	odwy
繜	oqph
繛	houj
繍	obqk
繌	odst
繋	deos
繊	ogki
縿	onnc
縼	otgp
縸	osjo
縲	ovos
縭	otwn
縬	okji
繴	blko
繵	oawf
繶	okjr
纝	ovvo
罜	ukjw
罖	urkd
罓	csik
罉	jifs
罁	jcqu
罀	jwii
缼	jxqf
缹	jibf
纼	kbus
纘	opwj
繺	oxbi
纗	ouel
纐	oakj
纊	omsk
纉	oooj
纈	ohlj
纅	odna
纄	osto
纃	oaqi
繿	ohgu
糭	qswt
糫	qufg
糪	blkq
笐	gaej
筕	gcic
筎	gclv
筃	gwod
筂	gnoe
筀	ghht
笽	gumz
笷	gkmz
笵	gnaj
笴	galv
笲	gnso
笰	gbka
笧	gwwf
笣	gwos
笡	gjqz
笟	gugz
笝	gwbo
笜	gwwk
笚	gvjz
笘	gulv
笗	gtir
笖	gekr
筗	gelu
筙	gdka
筟	gukz
箌	gdmd
箶	gjwy
箳	gbqs
箲	gnpw
箰	gwjk
箯	gefs
箮	giff
箟	gjnn
箞	gqoa
箖	gaau
箊	gtri
筡	grfa
箉	gfls
箈	gnnl
箄	gdgi
箃	glbo
箂	galz
筿	gtau
筫	gjbz
筨	grkl
筤	gkgg
笓	gnnb
笎	gflw
箹	gowk
笍	gcre
竃	ihjd
竁	immm
竀	ifpj
窹	idfl
窷	ilkm
窱	ieua
窧	iujz
窤	ijnn
窢	iklf
窡	ibbb
窙	ihkz
窔	iaks
窓	inri
窏	infh
窇	iwos
穾	imyx
穼	iaux
穻	ifhc
穳	mpwj
穱	muuh
穯	mhll
竍	kgil
竎	ksol
竓	kmml
竲	kqjj
笌	ghyz
笉	gwir
笇	gaub
笂	grkd
竾	goez
竻	gslz
竷	kjtt
竵	kflu
竳	kbfq
竰	kvvl
竔	kgso
竫	kxby
竩	kijq
竨	kujz
竧	kqsl
竤	kien
竡	kvjr
竛	krkb
竗	kigp
竕	kkmd
箷	gtgo
箻	gcba
糩	qrfj
籜	gfug
粐	qhhm
粎	qbkd
粊	nnqm
粈	qbcm
粇	qaej
粆	qigp
粅	qwcp
粂	xkqm
粁	qmqm
粀	qekd
籾	qmkd
籸	qygi
籷	qgxi
籶	qejm
籵	qgim
籱	gcee
籰	gjjb
籭	gfcm
籪	gnnd
籩	gqio
籢	grtp
粠	qska
粡	qcfl
粣	qwwf
糋	qqwm
糤	qswt
糣	qhwj
糡	qkjw
糛	qiht
糚	qsdh
糘	qits
糔	qbkq
糏	qbiw
糎	qvvl
糆	qsmm
粨	qvjr
糄	qhce
糃	qjfc
糂	quei
粺	qdgi
粷	qwqm
粶	qbns
粴	qvlm
粰	qukz
粭	qrhm
籡	gfrq
籛	gtkk
箼	gbdz
籖	ggkf
簅	gkgp
簄	ghlo
篿	gdhc
篽	gcga
篻	gpjs
篵	gcrp
篭	gkdd
篫	gpef
篧	gxeh
篣	gaqt
篢	gpjb
篞	gnjh
篗	gebo
篕	ghnu
篒	gksz
篎	gjig
篊	gnsk
篈	ghhh
篃	gbjm
箿	glle
箽	gmvl
簊	guht
簎	gfsj
簐	gdxq
簺	gish
籔	glgt
籏	gtgu
籎	gnjp
籋	gfks
籉	ghld
籈	gphr
籆	gseb
籅	gdhk
簻	groc
簵	gdtl
簓	gwhc
簲	gwdg
簯	gauq
簭	gprl
簬	gptl
簩	giis
簨	gook
簥	gmll
簤	gujb
簢	gdte
耺	lina
聀	lkge
藈	sjbo
葮	sele
葥	sqwm
葤	sohc
葟	sdjw
葞	sble
葝	sfls
葕	scni
葒	sopg
葐	skmu
葌	sccc
葄	swgu
葃	sjgu
葁	sqcn
葀	sfls
萾	sgbu
萻	skjr
萷	siwm
萶	sojr
萴	sjmd
萰	sawq
萭	sgqc
萪	smig
葪	sxsm
葲	sdns
聁	lkmd
葼	sswt
蒾	sqoc
蒷	sljb
蒵	suno
蒰	sues
蒫	sqpg
蒩	smjq
蒥	skvt
蒤	snra
蒢	spra
蒝	svdi
蒛	sjbr
蒚	sflu
蒖	sgjk
蒕	swru
蒓	soxw
蒏	sxpy
蒊	senn
蒆	spec
蒅	snra
蒃	sets
葿	sbjm
萢	snwo
萠	swwy
萟	smrk
萞	scrn
菕	srfc
菐	iqof
菃	snhb
莿	sacm
莮	svsl
莭	sbna
莦	siwy
莥	shbc
莡	spzo
莟	srkl
莝	srrh
莗	sdco
莔	swkc
莑	stdf
莐	snxw
莏	sfig
莍	sfnk
莌	sqlw
莇	sjsl
莄	sfjs
莃	sseu
菗	sfdo
菙	smso
菚	skkg
菺	shwy
萛	sjso
萙	saxw
萔	sfml
萓	sijq
萒	sakw
萈	sjkd
萇	suco
萂	smlv
萀	suho
菷	sbxu
菞	smwg
菶	soak
菵	scqt
菳	stjo
菭	snnl
菬	snml
菦	sdoc
菤	sqoa
菣	shbo
菢	sfwo
蓅	snaw
蓈	skbp
蓌	srrt
蕇	sllg
薉	spki
薃	snag
薂	sdtt
薀	snwu
蕿	siub
蕽	scsm
蕷	skvj
蕶	scrb
蕵	sxks
蕱	smiw
蕮	sdwi
蕦	scvj
蕢	sljj
蕟	sbbe
蕜	suri
蕛	smqg
蕕	shqp
蕔	shqb
蕒	sujb
蕐	sfra
蕏	shhj
薍	sube
薎	suxk
薐	smht
薴	sira
藇	sdhk
藆	sisf
藄	suos
藃	saxq
薽	sphr
薼	smht
薻	snla
薸	snpj
薶	svvl
薲	sifj
薒	suxq
薱	siqh
薧	safn
薟	srqo
薞	sfxk
薚	sfxc
薘	shqo
薗	swhg
薕	smqk
薓	snbb
蕌	sjjj
蕆	skjb
蓎	smbl
蕄	sdri
蔅	sdcn
蔄	sdlv
蓾	sulo
蓻	shqk
蓹	scga
蓶	sleh
蓵	sffp
蓯	scrp
蓭	smod
蓫	stoc
蓪	sbso
蓩	skgs
蓤	siht
蓢	skbw
蓞	sudi
蓜	spoi
蓛	sact
蓙	smrh
蓘	sakg
蓔	sqib
蓒	sdng
蔆	snht
蔇	sbnw
蔈	spjs
蔢	snbc
蕂	swqs
蔶	shjb
蔲	sift
蔱	ssae
蔮	swkf
蔨	swqa
蔧	sddb
蔦	sdno
蔤	siru
蔞	slgc
蔉	sakg
蔝	sjqm
蔜	shwt
蔙	stgp
蔖	sujq
蔒	sbgi
蔐	saqj
蔏	saql
蔋	snjb
蔊	sijn
莀	smco
荹	spiv
荶	slry
胹	wsry
腵	wbib
腲	wvhf
腬	wkga
腤	wkjr
腣	waqu
腟	widz
腞	wets
腖	wajr
腏	wbbb
腅	wiih
腀	wrfc
脿	whgy
脼	wfub
脵	wlfo
脴	wglv
脳	wnsw
脨	walv
脠	wgpg
脜	wvjm
脙	wfnk
脇	wsss
腶	wele
腷	wflv
膃	wwru
膶	wdjw
臤	hboe
臡	sflr
臗	wisk
臖	dcfw
臔	whbj
臐	wmgh
臈	wsje
臄	wuts
膷	wkgp
膱	wkjk
膅	wmbl
膮	whhl
膤	wcbj
膡	wqoj
膟	wang
膖	wtdo
膓	wgjc
膒	whll
膐	tggr
膌	wiiw
脀	ynfw
胷	wsww
臫	qeii
胵	wdzy
郩	sewp
聭	ldge
聫	lnno
聥	lgqc
聤	laad
聢	lifp
聡	lknr
聠	lqso
聟	jlle
聝	lklf
聜	lipg
聙	lhwy
聗	lorr
聕	lplv
聓	pekl
聐	lhlv
聏	lsre
聎	lwii
聉	lwwk
聈	lnsl
聅	ljie
聴	lgur
聵	lljj
聸	lxvb
肰	whqy
胮	wtak
胓	wnqk
胑	wlka
胋	wulv
胅	wgof
肻	uxwy
肹	wkhk
肵	wdjy
肳	wwcp
肧	wguy
聹	lira
肦	wkmd
肞	wbkd
肙	lwyv
肗	wcny
肒	wrkd
肑	wwkd
肍	wrjy
肂	fxba
聺	liwj
臩	hhok
臮	qerr
荵	smkr
芔	wwwc
茒	sxpf
茋	skxk
茊	sdfi
苸	sgqh
苵	sgof
苰	sbna
苮	seus
苬	swre
苩	sdbo
苨	sbnb
苝	sqnb
苚	ssyo
苐	sbug
苉	slei
苅	ssmd
苃	sebo
苂	siho
苀	saej
芢	seir
芞	sgqo
芖	sodo
茙	skez
茟	sbak
茠	seau
荌	sicn
荴	sfof
荲	svlo
荱	sbmm
荰	saht
荢	sifh
荝	scmd
荕	swsl
荎	sdzo
荍	swtp
荋	ssro
茡	sikz
荁	sfjf
茾	sfso
茽	selu
茰	sjsi
茮	sjiv
茥	shht
茤	sxxx
茣	slfo
茢	sfxm
芕	sxxo
芌	sfhk
臯	qiig
芉	sngo
艈	uanw
艆	ukgg
艂	utdf
艁	uplv
艀	uukz
舿	uofh
舽	utak
舼	uska
舮	uhho
舧	ugek
舦	uokd
舚	lxvb
舙	llls
舘	rlib
舗	rhln
舓	ljwc
舃	dhib
臸	ddzz
臵	dtlv
臱	qitf
臰	qfxn
艊	uduj
艐	uswt
艒	ucij
艧	useb
芇	sujo
芆	sbkd
芅	skio
芁	sejo
艻	sslo
艵	qsxo
艬	uxlk
艪	uvjr
艩	uaqi
艥	ullk
艔	umsb
艣	uuvs
艢	uhrl
艡	uivt
艠	ubfq
艞	ugwi
艝	ucbj
艜	usfu
艛	ulgc
艕	uaqt
郥	jpfb
鑆	tiqh
郬	hwpf
鵃	udno
鴼	dtlv
鴹	qdny
鴵	wiid
鴴	cidn
鴲	njdn
鴰	ldns
鴯	sdnr
鴭	ddnd
鴬	nxdn
鴫	vdnt
鴪	idnx
鴧	iedn
鴤	dtir
鴠	jfdn
鴚	dalv
鴘	nsdn
鴖	oxdn
鴓	rgdn
鴑	cbdn
鴎	hsdn
鴌	fodn
鵂	eadn
鵇	gadn
鼳	dbjh
鵈	ldne
鶈	gbcd
鶃	ddwr
鶁	aidn
鵼	ipdn
鵶	fkdn
鵳	hwdn
鵭	tdnj
鵨	rldn
鵦	dbns
鵥	qamd
鵤	xsdn
鵢	qdns
鵘	bgld
鵓	gxkd
鵒	krld
鵐	prrd
鵏	ndnf
鵎	ucdn
鵍	ifld
鵊	orrd
鵉	tdny
鴋	tdnf
鴊	fpdn
鴅	wadn
鴄	ledn
鱵	vgkl
鱴	vsuk
鱳	vdna
鱱	vvsv
鱰	vuhj
鱯	vseb
鱭	vaqi
鱫	vuxt
鱪	vjhj
鱩	vcvt
鱥	vpki
鱢	vlla
鱡	vjke
鱠	vrfj
鱟	dssv
鱞	vufg
鱝	vgsj
鱜	vkgp
鱛	vqjj
鱚	vhlv
鱙	vhhl
鱶	vqog
鱹	vsle
鱺	vfcm
鳛	xvvd
鴁	mdny
鳾	fudn
鳵	ygdn
鳲	bdns
鳱	ndng
鳬	dejn
鳫	vdnh
鳨	dsln
鳤	xgib
鳚	xbjh
鲄	xalv
鳒	xqbk
鳂	xvhf
鳁	xjum
鲿	xiin
鲾	xflv
鲬	xbsy
鲝	qxvy
鲘	xdfl
鲓	xhhk
鶊	mbrd
鶍	jwcd
鶎	ijdn
麁	xmlm
黂	mgsj
黀	mlbo
麺	htsm
麶	attn
麲	atjj
麱	atnf
麮	athn
麭	atwo
麬	atbp
麧	atgy
麣	mllt
麢	mcll
麡	maqi
麠	mfvf
麜	mpau
麚	mbib
麙	mkfl
麘	mmjr
麎	mmcl
麌	mlfo
麊	qmlm
黅	sdky
黆	sdkw
黇	sdkl
鼆	xjag
鼧	dbin
鼦	dbml
鼥	dbek
鼡	neak
鼞	hgbh
鼝	nddb
鼜	hgbq
鼏	xjdd
鼊	blkg
鼅	jlgm
黈	sdkj
鼄	pkgm
鼁	hngm
鼀	hkgm
黺	iqum
黸	guvu
黭	grso
黖	ghwr
黕	gxwr
黊	sdkh
麆	mjql
鹻	uqbk
鶐	akod
鹸	urre
鷌	dwmn
鷊	flcd
鷈	dduh
鷆	njed
鷁	qkud
鶿	qnnd
鶸	bibd
鶷	idld
鶳	ddfu
鶰	ljdn
鶮	adng
鶫	awqd
鶧	scod
鶥	bjdn
鶤	xddn
鶢	unbd
鶜	skgd
鶙	aqxd
鶕	kjdn
鶓	svdn
鶑	iidn
鷐	jmdn
鷕	ledn
鷚	vvrd
鸌	dseb
鹷	urkb
鹶	urky
鹲	sxfm
鹟	knvm
鸘	cajd
鸗	kwud
鸖	cedn
鸏	sxfd
鸎	jjdn
鸈	iqkd
鷛	mbwd
鷼	djdn
鷻	dakt
鷶	ujdn
鷳	dwdn
鷱	qiid
鷰	sfld
鷤	lljd
鷠	vdnv
鷝	jsad
鱘	vbph
鱕	vgqv
鱐	vbdf
魞	vbuv
鮃	vnqk
鮁	vebk
魾	vgfi
魻	vvjv
魹	vmmv
魸	vdpv
魶	vcre
魴	vtfv
魳	vfuj
魲	vhhv
魱	vfem
魰	vtev
魮	vnnb
魭	vflw
魬	vdbo
魪	vrka
魩	vwcp
魧	vaej
魦	vigp
魥	vgkd
魢	voiv
鮄	vbka
鮅	vrgp
鮇	vfwv
鮚	vhlv
鮩	vqso
鮧	vobg
鮦	vcfl
鮥	vtlv
鮤	fxmv
鮢	vpka
鮡	vwii
鮠	vxva
鮜	vdfl
鮙	vvvx
鮉	vmlv
鮘	veki
鮖	vvsv
鮔	vhbo
鮓	vgub
鮒	vehc
鮐	vnlv
鮏	vpsv
鮍	vbpv
鮊	vdbv
魡	vwkd
魝	vmdv
鮬	vofh
魙	nddd
髵	usrb
髲	ubpb
髰	usib
髬	ugfi
髨	uflw
髧	uxwr
髜	ajgs
髛	abrj
髚	aaej
髕	rifj
髍	rmag
髉	rxeh
髇	ragg
骽	rucn
骵	rafi
骮	rkig
骬	rfhc
驫	wwwm
驨	wuel
驧	wswq
驦	wcaj
髿	unig
鬀	uqbg
鬁	ummd
鬪	dflh
魗	hypd
魕	dnnr
魐	dqbk
鬾	dgbo
鬸	flcv
鬮	dggm
鬭	dhbd
鬬	dkbd
鬫	dylt
鬦	digi
鬄	ujwc
鬤	uasg
鬡	uira
鬠	urfj
鬞	ucsm
鬜	udwy
鬗	usfb
鬕	usjo
鬌	uepw
鬇	uxby
鮫	vaks
鮱	vhnb
鱏	vpjz
鯿	vhce
鰦	vqnn
鰢	vwmv
鰠	vbkq
鰟	vaqt
鰝	vagv
鰛	vjum
鰚	viff
鰙	vsel
鰘	vidz
鰖	vepw
鰕	vbib
鰔	vkfl
鰑	vjfc
鰐	vllh
鰌	vqpy
鰋	vhjc
鰊	vawq
鰇	vkga
鰆	vojr
鰄	vkfc
鰁	vdns
鰨	vjvv
鰩	vujf
鰪	vhnu
鰿	vhjb
鱍	vbbe
鱌	vxlt
鱋	vuie
鱊	vkgl
鱅	vmbw
鱃	vqbc
鱂	vdwh
鱁	vtoc
鱀	bnhv
鰽	vsjj
鰫	virl
鰺	vnnc
鰷	veua
鰵	getv
鰴	cfvv
鰳	vssl
鰱	vdoc
鰰	vjds
鰯	vbii
鰮	vwru
鰀	vunb
鯼	vswt
鮲	vehq
鯺	vhjr
鯑	vseu
鯐	vhzv
鯏	vmmd
鯎	vkyi
鯍	vanw
鯌	vplv
鯋	vnig
鯇	vifl
鯅	vgpg
鯄	vfnk
鯃	vfbl
鯂	vpyv
鮿	vlei
鮾	vucn
鮼	vbxb
鮺	qvvy
鮷	vqbg
鮶	vbgl
鮵	vqlw
鮴	veau
鮳	vhhk
鯒	vbsy
鯔	vlvt
鯕	vuqv
鯪	vhkt
鯸	vebj
鯷	vjfp
鯵	vnoc
鯴	vygq
鯲	vtri
鯱	vuhv
鯯	vpcm
鯬	mwgv
鯫	vlbo
鯩	vrfc
鯙	vakz
鯧	vjjr
鯦	vtul
鯣	vjwc
鯡	vufv
鯠	valv
鯞	vbxu
鯝	vwjg
鯜	vkcn
鯚	vmkz
鼪	dbps
鼺	dbvv
郮	whlp
𫘝	bbre
𫘧	bbns
𫘨	bjfp
𫘪	bvdi
𫘬	buno
𫚕	xqfu
𫚖	pnxv
𫚭	xlwb
𫛭	hjmn
𫞩	jsfr
𫟅	kaiv
𫟦	xqto
𫟹	oska
𫟼	oooc
𫠆	gbvc
𫠊	bana
𫠜	prww
𫢸	eqjg
𫫇	llqr
𫭟	hhsi
𫭢	hrnb
𫭼	hsxs
𫘦	bwjf
𫘜	btem
鼼	qvlw
𫗴	xawf
𫇭	sksk
𫌀	xhcb
𫍣	dcfl
𫍯	dkfl
𫍲	ddub
𫍽	dufg
𫐄	xlwj
𫐐	xdwr
𫐓	xkga
𫑡	ldpf
𫓧	oofj
𫓯	ohht
𫓶	olwy
𫓹	ouqj
𫔍	ogqv
𫔎	okgl
𫔶	tqau
𫖮	uovc
𫖯	wiic
𫖳	bglc
𫗧	xalv
𫮃	hqjg
𫰛	cbpg
𫵷	uvsl
𫶇	usxu
𬘫	kifl
𬘬	khwy
𬘭	kaau
𬘯	kakz
𬙂	kifk
𬙊	kght
𬙋	kasg
𬜬	stlv
𬜯	sfcr
𬞟	spic
𬟁	sflm
𬟽	qxiv
𬣙	dfhc
𬣞	difi
𬣡	dfkg
𬣳	dggy
𬤇	dpht
𬤊	djfp
𬤝	ddri
𬨂	xkxi
𬨎	xqpy
𬘩	kmgy
𬘡	kwod
𬘘	kxwr
𬉼	ihsi
𫷷	moxq
𫸩	bhsi
𬀩	jayi
𬀪	jcjr
𬂩	aoqk
𬃊	adgc
𬇕	nfwb
𬇙	ncbs
𬇹	nwjk
𬊈	ibhc
𬘓	klcj
𬊤	iqjg
𬌗	hrhy
𬍛	jkiv
𬍡	nyck
𬍤	jbhc
𬒈	nxvs
𬒔	vpwy
𬒗	vugc
𬕂	gpcb
𫄸	kmgh
𫄷	kkjr
𫄨	kseu
䗴	qgmg
㸆	iplu
㸌	iceh
㺄	hrfm
㻬	jcfh
㽏	nrsi
㿠	dilw
䂮	dmvs
䃅	vqjg
䃎	voxx
䌹	kclv
䎃	chvv
䎖	qjqv
䏡	wjsy
䏲	wqbg
䐃	wwmh
䓛	sbww
䓨	sxjf
䓫	soal
䓬	sujz
䗖	qsxu
䗛	qeuw
㶲	isyh
㵐	nvqx
㴔	nxbr
㥄	rhkt
穭	mvjr
㙘	hpcn
㙦	rfah
㛃	dmcn
㛚	cbsy
㛹	cefs
㟃	uyfl
㠇	uaif
㠓	usxt
㧑	fksk
㳚	nkkd
㫰	jkgg
㬊	junb
㬎	jnni
㬚	jant
㭕	ahna
㮾	kbna
㰀	amwn
㳇	nksi
㳘	nanw
䗪	msfq
䝙	vhsi
𫄧	kgpg
䢺	wwpf
𧿹	pemz
𨐈	xilw
𨙸	gbpf
𨚕	nspf
𨟠	jjep
𨭉	tfkt
𨱇	ofnk
𨱏	osrh
𨱑	osdk
𨱔	oqph
𨺙	pdwr
𩽾	xicn
𩾃	xxlw
𩾌	xmbn
𪟝	hcsl
𪣻	hqcn
𪤗	hvvc
𪨰	ucso
𪨶	uoxj
𪩘	ugch
𪾢	jcjm
𦰡	syap
𦭜	slka
𦝼	wqcn
𣲘	nffo
䢼	skpf
䣘	ihpf
𠅤	avri
𠙶	kwke
𠳐	ldpf
𡎚	hhce
𡐓	hmbn
𣗋	aiwr
𣲗	nayi
𣸣	ngsc
𦙶	wjgy
𤧛	jaqu
𤩽	jgch
𤫉	jbib
𥔲	vllh
𥕢	vsjj
𥖨	vlla
𥻗	qajf
𦈡	kcsr
𦒍	kvvv
𬩽	bhpf
𬪩	pxgy
𬬩	okij
㘚	ldyt
䜩	dsfi
䜣	ddjy
䜌	boos
䙡	xljj
䙌	xljc
䓖	sisl
䏝	wiek
䎱	dkun
䎬	dkun
䌷	kdoj
䅟	mnoc
䁖	jqcn
㳠	nooc
㱮	fxlc
㭎	acsi
㩳	feeb
㧟	fnhf
㧐	fbbo
㧏	fcsi
㥮	rwww
㤘	rxbj
䝼	jhwy
䞍	chwy
䥇	thvv
䲟	xkfa
䴗	jhmn
䴖	hwmn
䴕	fxmm
䴔	aksm
䴓	fumn
䲣	uxtp
䲢	wqox
䲡	xqpy
䲠	xojr
䱷	uvtp
䥺	ohyj
䦷	trrh
䦶	txby
䦟	drrh
䦛	dxby
䦆	ojjb
䦅	oqql
䦃	oshj
䦂	ohvv
䥽	owbk
㣺	rkdx
㘎	ltyt
䴙	blkm
㖞	llcr
齩	paks
齨	pdic
齥	pdgp
齤	qopc
齠	pmlv
齞	plka
齝	pnlv
齛	psic
齚	pgub
齙	pwos
齘	prka
齗	pdjc
齖	phyc
齓	peic
齍	aquu
齈	qvlm
齇	qvlj
齅	qvlh
齂	qvln
齀	qvlr
鼿	qvll
齭	pddj
齯	pdwr
齱	plbo
龣	rcbn
㔾	aj
㓁	xkam
㑳	ewww
㑇	exbj
龸	is
龷	so
龶	hs
龵	fs
龴	bo
龡	rcxq
齳	pxdc
龝	mggm
龗	cllu
龖	kwuu
龓	ewku
齾	uflp
齽	paaj
齺	pwww
齹	qppc
齴	pkgc
䴘	dumn
䶮	fgfo
𬬭	ornb
𬸪	gqvm
𬱟	xvac
𬳵	bgfi
𬳶	bclv
𬳽	bpwr
𬳿	brfa
𬴂	bufm
𬴃	bdvs
𬴊	bqxa
𬶋	xwlv
𬶍	xinb
𬶏	xxva
𬶐	xwii
𬶟	xalm
𬶠	xawq
𬶨	bnhx
𬶭	xwjs
𬶮	xhlv
𬷕	nmnf
𬸘	hjcm
𬸚	hdhm
𬸣	iskm
𬱖	dvcb
𬯎	pljc
𬯀	ptka
𬭚	oakz
𬬮	oncj
𬬱	odjj
𬬸	oakd
𬬹	odsj
𬬻	oubs
𬬿	omlv
𬭁	oemj
𬭊	oaht
𬭎	oien
𬭛	onbp
𬮿	puoi
𬭤	oebj
𬭩	oknv
𬭬	oddb
𬭯	oqut
𬭳	ohlv
𬭶	oghj
𬭸	oqxa
𬭼	oqto
𬮱	tpht
𬸦	tgjm
𬹼	prwk
𠂆	dj
𬺈	prwl
秊	mmqh
凉	iali
郎	kgpf
⺻	bfij
⺶	qy
⺄	yi
𧾷	pz
𦍌	qy
𥫗	gz
𤴔	ypii
𤇾	iixm
𢦏	gkgi
𡭔	iv
𡗗	op
𠦝	gjzi
𠔉	kofa
𠃌	yi
𠂒	pn
𠂊	xm
𠂉	gz
𠂇	ez
裏	avgy
隣	pqxa
兀	lw
﨤	gkoc
㙍	hbbb
㕮	lksi
㑊	etyr
鿏	ohtp
鿎	vooc
鿍	htak
﨩	pdus
﨨	thqg
﨧	thkz
﨣	higi
嗀	hflv
﨡	qpsc
蘒	smgg
﨟	swje
礼	jeis
﨔	ankf
﨓	aseh
﨑	ukly
﨏	hkrl
﨎	tebo
驣	wqow
驡	kwuw
驠	wsfi
鍿	tlfv
鍻	tjwe
鍹	tiff
鍸	tjwy
鍷	tohh
鍶	tvri
鍴	tusr
鍳	hgtj
鍲	toxj
鍱	tsau
鍰	tunb
鍯	twcr
鍫	mitj
鍩	tsel
鍨	tbfo
鍦	ttgo
鍤	tmdi
鍣	tsml
鍢	tflv
鍡	tvhf
鍟	tjps
鍝	tvyj
鍽	thce
鎀	teuc
驞	wifj
鎄	tagy
鎪	tdub
鎨	tegi
鎦	tkvt
鎥	eutt
鎤	tjil
鎣	iixt
鎠	tufp
鎟	tbba
鎜	uetj
鎘	tflu
鎕	tmbl
鎓	tknv
鎑	thnu
鎐	tujf
鎎	tgqm
鎍	tgxo
鎋	tidl
鎉	tjvv
鎈	tqpg
鎇	tbjm
鎆	tqwm
鍜	tbib
鍙	nskt
鍕	txdc
鍔	tllh
錜	trkr
錗	tmcn
錖	jibt
錔	tnjr
錓	tqei
錒	tpal
錏	tfka
錌	tuvn
錊	targ
錈	tqoa
錇	tklv
錃	nbtj
錂	thkt
錁	tjau
鋾	twjf
鋽	tujz
鋻	hbtj
鋺	tixa
鋷	tlbo
鋶	tanw
鋴	tjwr
錝	tijs
錟	tiih
錤	tuqj
鍃	twcr
鍓	tlle
鍒	tkga
鍐	tswt
鍏	tbwj
鍎	tdgj
鍌	npwt
鍆	tdmj
鍅	tnhn
鍄	taiv
鍁	tdxq
錥	tanw
錼	tojs
錻	tfkp
錺	tstf
錸	talj
錷	tdei
錵	tsen
錰	taib
錭	twhl
錩	tjjr
鎰	tqku
鎱	thlg
鎳	tqau
鐓	takt
鐿	tkjr
鐽	thqo
鐼	tgsj
鐹	troc
鐷	tssa
鐴	tblk
鐱	trqj
鐰	tlla
鐯	tshj
鐬	tpki
鐪	tuvs
鐨	tbkj
鐤	tjdd
鐢	asst
鐠	tqij
鐟	tooj
鐞	tbph
鐝	tvqx
鐜	aktt
鐛	tjai
鐗	tdwy
鑁	tswt
鑂	tmgh
鑃	tvve
鑘	tvvv
鑪	tuvu
鑩	tjll
鑧	tisk
鑦	thbj
鑥	tvjr
鑡	tpcj
鑟	thuj
鑝	tsto
鑜	tijb
鑖	tsuk
鑅	tiia
鑓	tljo
鑐	tcsr
鑏	tira
鑎	thlj
鑍	jjtj
鑌	tifj
鑉	tshu
鑈	tfks
鑇	taqi
鐔	tpjz
鐒	tiis
鎴	tqri
鐑	tohl
鏥	tiej
鏝	tjub
鏛	tiuj
鏚	tkji
鏒	tnnc
鏎	tjsa
鏍	tvos
鏋	tsfb
鏆	tegj
鏅	teuw
鏃	ttgj
鏂	thll
鏀	tulj
鎾	tjum
鎽	tutd
鎺	tjjq
鎹	tqoo
鎸	tegn
鎷	twmj
鎶	tall
鎵	tits
鏩	tddj
鏪	tsjj
鏫	tmma
鏾	tswt
鐎	teib
鐊	tpjc
鐉	took
鐈	tmll
鐆	pqtt
鐅	qukt
鐂	tlhv
鐁	tudj
鐀	tljj
鏸	tdri
鏬	tugh
鏷	tiqo
鏶	teau
鏵	tsns
鏴	tptl
鏳	tqjj
鏲	tanp
鏱	tkjz
鏯	toss
鏭	tgqr
鋲	tdfk
鋰	tvlj
鋯	tplv
醥	ppjs
釫	tfhk
釩	tekd
釥	tivj
釤	tcpj
釢	tgnj
釠	tejj
釞	tbuj
釛	tslj
釙	tubj
釖	tmdj
釕	tkej
釔	tyij
釓	teij
釒	tj
釈	gqbk
釅	pllt
釄	pmuf
醾	pmqm
醻	phyh
醶	prqy
醳	puhg
釮	thgp
釯	ttwj
釰	tmkd
鈁	ttfj
鈙	tubo
鈘	tgbo
鈗	tnwr
鈓	tmrj
鈐	trky
鈏	tbus
鈋	tenb
鈈	tguj
鈂	txwr
鈀	tobj
釱	todj
釾	thyj
釽	tuzj
釻	trkd
釺	tmqj
釸	txxj
釷	thtj
釶	toej
釴	tkij
釲	tosj
醦	pnnc
醠	pcou
鈝	tpnj
醟	iixp
鄳	gpfm
鄬	ugpf
鄪	bkjp
鄦	gsfp
鄥	dpfn
鄝	vvrp
鄖	ljpf
鄕	kgdp
鄓	qhpf
鄑	lqjp
鄎	qrpf
鄍	xjap
鄌	mblp
鄋	dubp
鄇	ebjp
鄁	qnwp
郻	jelp
郺	xxlo
郹	jhpf
郳	dwpf
郲	apfl
鄵	lllp
鄶	rfjp
鄸	suxp
酦	pwbk
醗	pbiw
醈	piih
醆	pkkg
醂	paau
醀	pehy
酻	pukz
酳	pnwy
酭	pewy
酫	prjw
酠	palv
鄻	oodp
酜	pofy
酛	pflw
酓	rkyp
酇	pwpp
酄	sllp
酁	xlnp
酀	sflp
鄿	sllp
鄾	vwxp
鈜	tena
鈟	tbus
鋫	mmtj
銂	tnlc
銱	tluj
銰	tssi
銪	tewy
銩	tmna
銦	twod
銥	tagy
銤	tqmj
銣	tclv
銠	thnb
銟	tuuj
銝	teau
銚	twii
銗	tdfl
銔	tggi
銑	tpwr
銐	fxmt
銏	twwf
銌	teuk
銋	temr
銇	tdka
銆	tvjr
銴	fdtj
銵	tqsj
銺	dhtj
鋛	tllu
鋨	tgfk
鋧	tjjj
鋦	tbyl
鋣	thpf
鋢	tukz
鋠	tmcj
鋟	tbxb
鋝	tuhc
鋜	tpzj
鋚	eutt
銽	tkxl
鋖	tucn
鋔	txlw
鋓	tmmd
鋑	tnkt
鋏	torr
鋍	tgxk
鋊	tkrl
鋇	tjbj
銿	tbsy
銄	tdxj
銁	twjr
鈠	tesj
鉿	trhj
鉃	tjij
鈽	teuj
鈼	tgub
鈻	tbbo
鈹	tbpj
鈷	tjgj
鈶	tnlv
鈵	tfcr
鈳	talv
鈲	tugj
鈱	toxi
鈯	twwk
鈮	tbnb
鈭	pntj
鈬	tbkd
鈫	ttej
鈪	tvaj
鈨	tflw
鈧	taej
鈥	tihj
鈤	tjrj
鉇	tgoe
鉈	tinb
鉎	tpsj
鉫	tslv
鉽	tkpg
鉺	tlej
鉹	txxx
鉳	tqnb
鉱	tmna
鉯	tekr
鉮	tdsj
鉭	tjfi
鉬	tjmj
鉪	tsij
鉐	tvsj
鉩	triv
鉧	temj
鉡	tqak
鉠	tcod
鉟	tgfi
鉜	tehc
鉘	tbka
鉕	thlv
鉑	tdbj
鑭	tdaq
鑮	tsnh
鑳	tisp
飉	eoqi
餝	kstf
餙	kseu
餖	kflq
餕	knkt
餏	kagy
餇	kcfl
餆	kwii
餁	kemr
餀	kssi
飿	kwwk
飻	krcp
飹	kkms
飷	kjqs
飳	kkjw
飰	kaub
飥	kgxi
飣	kads
飠	ks
飝	yyyf
飜	gqvy
飍	eeef
餢	kklv
餣	kodd
餤	kiih
餺	knhc
饙	kgsj
饖	kpki
饓	kiau
饊	kswt
饆	kjsa
饄	kiht
饃	ksjo
饂	kjum
饁	khnu
餹	kmbl
餥	uksf
餷	kajf
餴	kogs
餱	kebj
餰	kcni
餯	kets
餭	kdjw
餫	kxdc
餩	krth
餦	kucs
飌	slle
飅	elhv
饝	kmvs
颾	ebkq
顉	tvjb
顈	novj
顅	hwvj
顄	ynwj
顃	iivj
顂	avjb
顁	ifpj
顀	evjb
頿	cpnj
頺	mgvj
頶	plvj
頴	njvj
頲	mgvj
頱	uhvj
頯	wsvj
頮	nsvj
頧	dvjb
頥	uhvj
頢	lvjb
頝	aksj
頛	dkvj
顊	dgvj
顐	xdvj
顖	dsrj
颒	nsvc
颽	ufle
颹	ebwf
颷	eiih
颵	eiwy
颲	efxm
颰	eebk
颮	ewos
颫	eoff
颪	jefx
顲	iiaj
顙	bbbj
顮	ifij
顭	suxj
顬	csvj
顪	pkfj
顩	rvjb
顤	hhhj
顣	kjij
顝	rvjb
顜	schj
饚	kshu
饠	kuoe
頖	qavj
駵	wlhb
騬	wmqn
騪	wdub
騥	wkga
騤	wbfo
騢	wbib
騡	wdns
騟	wrfm
騛	wyfm
騚	wqwm
騘	wwcr
騗	hcwm
騍	wjau
騌	wijs
騉	wjnn
騈	wgnn
騇	wrls
騆	wwhl
騀	wgfk
駽	wlwy
駻	wjng
駺	wkgg
騮	wkvt
騯	waqt
騱	wuno
驇	hkhw
驝	whxa
驜	wiqk
驙	wawf
驘	twmw
驓	wqjj
驐	wakt
驏	wbkk
驋	wbbe
驉	wuie
驆	wjsa
騲	wsjz
驄	wdtr
驂	wnnc
騿	wkjz
騻	woss
騸	whvv
騶	wwww
騵	wvdi
騴	wjic
騳	wwmm
駶	wbyl
駳	wgpg
饡	kpwj
駲	wnlc
馸	wdjm
馷	wfuj
馶	wgbo
馵	wsom
馲	wgxi
馰	wwkd
馯	wngm
馫	mjmj
馪	mjij
馧	mjju
馦	mjqk
馤	mjje
馣	mjod
馢	mjkk
馠	mjrl
馟	mjuk
馜	mjbn
馛	mjek
馚	mjkm
饻	xagy
饢	kglg
馼	wtem
馾	wxwr
駀	wfom
駠	wkmm
駰	wwod
駯	wpka
駫	wilw
駩	wrjw
駨	wwjr
駧	wcfl
駦	qowm
駤	wdzm
駣	wwii
駜	wrgp
駂	ngwm
駚	wcod
駗	wrcp
駖	wrkb
駎	wdom
駍	wnqk
駋	wmlv
駈	wdfi
駇	wtpm
駅	wbkd
頙	fpvj
頕	ulvj
鑶	tskh
闚	dojj
陯	prfc
陮	pehf
陭	poal
陫	puff
陦	pdhc
陥	pxuj
陠	pnff
陚	pfkp
陘	pflp
陖	pnkt
陓	pofh
陎	ppka
阷	pfpi
阭	pnwr
阩	pgso
阦	pihf
阥	pnsf
阣	pgyi
闧	dhlo
闦	dcsq
闞	dylt
陱	pwqm
陹	pgsj
険	prre
隝	pdnf
隵	pufk
隲	pigw
隯	phyh
隭	pcsr
隫	pgsj
隦	pblk
隥	pbfq
隡	pkgp
隞	phwt
隚	piht
陻	ppht
隖	pdwf
隓	pepp
隒	pqbk
隑	pufq
隉	pdpg
隇	pkfc
隂	pruc
隁	phjc
陾	psod
闛	diht
闙	dhlt
隺	xehm
闗	dnni
閗	digi
閖	dnsm
閐	dmmm
閍	dtfm
閌	daej
閊	dusm
閈	dngm
閇	djxm
閅	dadm
閄	drem
閁	dgpm
镾	ufks
镽	uoqi
镻	ugof
镹	uxkd
钂	tigh
钀	tufh
鑻	tasf
鑺	tjje
鑹	tidb
鑸	tvvh
閙	dauj
閚	dklm
閜	dalv
閺	djte
闏	defm
闎	ddns
闅	djub
闄	dpcn
闂	dqoa
闀	dsko
閿	duxb
閾	dklf
閽	dkxj
閸	dfka
閝	drkb
閷	sadr
閶	djjr
閵	dehm
閳	ddcm
閯	dnig
閬	dkgg
閫	dwau
閪	dpxm
閠	djkd
隷	hjbn
隿	kehi
頏	aevj
靟	ummf
韅	sjni
韀	smhi
鞾	ssns
鞼	sljj
鞻	slgc
鞸	sjsa
鞪	kgts
鞩	siwm
鞤	hhhs
鞢	ssau
鞝	sisg
鞛	sklv
鞐	sjjx
鞊	shlv
鞇	swod
鞂	smhg
靻	sjqg
靹	scre
靵	sbcg
靲	srky
靫	sbkd
韊	ssdq
韍	bebk
韎	bfmw
韤	bsuk
頎	dvjb
頊	jvjb
頄	rvjb
韼	kjto
韺	kjso
韸	kjtd
韴	kjfu
韯	gkuf
韥	bhuj
韣	buwq
韐	brhw
韢	bdri
韠	bjsa
韟	bdog
韞	bjum
韛	bsgs
韚	bsgw
韘	bsau
韕	bakz
韑	ilbw
靧	sljj
靝	hwgq
雂	rkye
靗	hwil
霗	cnrb
霕	cinw
霒	ciny
霐	cnbn
霌	cwhl
霋	cgbc
霃	cnxw
雿	cwii
雼	cvsy
雵	ccod
雴	ckly
雭	cgkd
雬	cauy
雧	eeea
雦	eeeh
雥	eeeh
雤	dsse
雡	vvre
雓	rfae
雐	uehh
雈	seho
霛	cbbb
霠	ckry
霣	cljb
靀	csxt
靕	fphw
靔	hwgq
靐	cvcv
靍	cedn
靌	cijj
靊	cudq
靅	cinj
靃	ceeh
靁	cvvv
霼	cinq
霥	cxft
霻	ccsq
霺	ccfe
霷	cjjc
霶	cnat
霵	cllk
霴	cinn
霱	ckgl
霯	cbfq
霮	cnue
穮	mmib
匶	hsed
穪	mfks
嬯	chld
嬭	cfks
嬫	ciia
嬩	cdhk
嬨	cqnr
嬧	cbfu
嬦	chyh
嬥	cvve
嬣	cira
嬠	clla
嬞	csmv
嬙	chrl
嬘	cqto
嬕	cuhg
嬓	cdtt
嬒	crfj
嬑	ckjr
嬍	cuft
嬊	sflc
嬆	crvv
嬄	chxq
嬃	cvjc
嬮	vjwc
嬱	nddc
崫	ubww
嬳	cseb
孷	ftvk
孶	snnk
孴	kkkj
孯	hbkz
孭	kjbz
孧	nskz
孡	knlv
孠	yflk
孞	kriz
孏	csdq
孎	cbnq
孍	cllt
孌	booc
孇	ceeb
孄	cdaq
孂	cggu
孁	cllc
嬽	cuuo
嬼	cktm
嬶	cqvl
嬵	codu
嬂	ckjk
嫼	cghn
嫹	csdk
嫸	cqql
媯	ckgw
媫	cubp
媨	cqpy
媤	cvri
媣	cnra
媡	cawq
媠	cepw
媙	ckfc
媘	cnnd
媑	cmvl
媐	hocn
媏	cusr
媎	chjr
媍	cxjb
媋	cojr
媊	cqwm
媉	cbdz
媈	cxdc
媇	ckau
媆	csod
媅	cuei
媰	cwww
媴	chlg
媶	csle
嫤	csir
嫷	cpew
嫶	ceib
嫴	cjkx
嫳	qukc
嫯	hwtc
嫬	cmsi
嫨	csfo
嫧	chjb
嫥	cdhc
嫢	ojcn
媷	cmhc
嫝	cmbn
嫛	hjec
嫓	cxcn
嫑	gpcn
嫎	caqt
嫍	cudi
嫊	chos
嫅	cqpg
媹	ckvt
孻	kbfu
孾	kjjc
宂	iejb
岅	udbo
峓	uobg
峍	ubak
峌	udzs
峉	utlv
峈	utlv
峆	urhs
峃	nxus
峂	utir
峀	udos
岾	uulv
岼	unqk
岻	ukxk
岹	umlv
岴	udfi
岲	ulwr
岯	ugfi
岪	ubka
岦	ukls
岤	uixs
岟	ucod
岓	udjs
峔	uhnb
峕	uajr
峖	uicn
崊	uaau
崥	udgi
崣	umcn
崡	uynw
崠	uajr
崝	uhwy
崜	umso
崘	urfc
崓	uwjg
崍	uals
崉	unjr
峚	uoht
峿	ufbl
峾	ndus
峸	ukyi
峳	ueut
峲	ummd
峩	ugfk
峢	ufxm
峝	ucfl
峜	urpi
岋	ugkd
岄	uwys
宎	imyb
岃	umkd
寲	injp
寱	idqa
寭	idri
寪	iugw
寣	idby
寠	ilgc
寚	ijjf
寙	iuug
寎	idfr
寍	irum
寋	iska
寈	ihwy
寁	ifbp
宺	iljw
宲	ilau
宱	iegu
宩	iqmb
宔	ikjw
宒	immb
宑	iika
宐	ixfi
寴	ikaj
寷	iudq
尒	rive
屚	bcys
屾	uuss
屸	upgs
屷	ugns
屵	uvhs
屳	busu
屲	gusp
屰	qwck
屫	bdml
屨	bclc
屒	bmcs
尛	iiiv
尵	fljj
尳	frgo
尲	fqbk
尰	fmvl
尮	fgau
尭	gslw
尡	iljn
尠	ueig
尞	oqji
媄	cqod
媁	cbwn
媀	cvyn
墔	hueh
壔	hhyh
壐	fkuh
壍	nddh
壋	hivt
壉	huts
壀	hblk
墽	hdtt
墺	hdqo
墹	hdjr
墸	hshj
墷	hsns
墴	hsdk
墲	hgsi
墱	hbfq
墰	hpjz
墭	hkyu
墧	hmll
墤	hljj
墢	hbbe
墛	hbjh
墖	hrvt
壚	huvu
壛	hdxd
壜	hjcn
夁	huwj
夡	xxhl
夝	xpsx
夛	bxxj
夗	xajx
夓	vjdt
夒	vjpt
夎	rrht
夌	hktp
夃	gbon
壿	hqph
壝	hljo
壷	hxlf
壵	hhhs
壴	hz
壭	hajs
壪	hbob
壨	vvvh
壧	hllt
壦	hsle
壠	hkwu
墕	hfpi
墏	dwhh
夨	eodi
墍	dnhh
塓	hxjk
塏	hufq
塎	hirl
塇	hiff
塃	hstw
堾	hojr
堼	hhhh
堻	nbah
堹	hmvl
堸	heft
堶	hepw
堲	bnah
堭	hdjw
堬	hrfm
堫	hswt
堨	hjwe
堦	hnnd
堢	hela
堟	hets
堜	hawq
堛	hflv
塕	hknv
塖	hmqn
塛	hpau
塲	hgjc
墋	hnnc
墇	hkjz
墄	hkji
墂	hpjs
塻	hsjo
塸	hhll
塷	hult
塶	hmlt
塳	htdo
塱	kbnh
塝	haqt
塰	ngeh
塯	hkvt
塮	hqhc
塪	hudi
塧	hqku
塦	pdht
塣	nljh
塡	hnjk
塠	hdoc
夦	uexx
夳	oird
婾	cbfl
姧	ccng
娻	cajr
娺	cbbb
娹	cban
娸	cuqn
娷	cmso
娯	clek
娮	cbyn
娦	cdfk
娤	dhcn
娢	crkl
娝	cglv
娐	cukz
娎	fdcn
娊	cjjn
娂	cska
姾	crjw
姼	cxxx
姷	cewy
姳	cxlv
姲	cicn
姯	cilw
娽	cbns
娾	cvhh
婃	cijs
婡	caln
婽	cbib
婹	cpcn
婱	banc
婯	fcfc
婮	cbjg
婫	cjnn
婩	cuvn
婨	crfc
婣	cddf
婟	cwjg
婅	cwqm
婝	cifp
婛	caiv
婔	cufn
婒	ciih
婏	cxlk
婎	cehn
婋	cuhn
婈	chkt
婇	cuau
姭	sssc
姢	cnwy
夵	oivd
姛	ccfl
妎	crka
奾	cusn
奻	ccnn
奰	uuuo
奯	opki
奫	ondf
奨	quho
奦	kgto
奣	fojw
奟	owwy
奞	oehd
奝	owhl
奛	ojwy
奙	nodd
奒	othd
奊	hheo
奆	ohbo
奅	okmd
奃	okxk
夽	oina
夶	oodd
妐	ckna
妑	cobn
妕	clus
妽	cdsn
姙	cemr
姕	pncn
姏	csir
姉	cfuj
姇	ehcn
姄	coxi
姃	cfpi
姂	cgoz
姀	cmhn
妼	crgp
妚	cgun
妷	cgof
妴	xacn
妭	cebk
妦	cdfn
妢	ckmd
妡	cdjn
妟	jcnr
妜	cbre
妛	wfcn
崨	ufbp
崬	uajr
揤	fbna
慦	fnkr
慠	rhwt
慞	rkjz
慜	getr
慗	altr
慖	rwkf
慐	pjri
慂	nbsr
愼	rnjk
愻	kgor
愺	rsjz
愹	rirl
愸	asri
愶	rssw
愲	rrgx
愱	rmji
愮	rujf
愪	rljb
愢	rvri
愡	rwcr
愙	itlr
愌	rxco
慡	ross
慪	rhll
崯	utjs
慸	sfxr
憮	rgsi
憦	riis
憥	iixr
憢	rhhl
憡	rgac
憠	vqwr
憜	rpew
憛	rpjz
憘	rhlv
憓	rdri
憒	rljj
憌	twir
憈	ruie
憆	riht
憅	mvsr
憄	cgjr
憃	odri
憁	rdtr
慿	iwsr
慺	rlgc
慹	hqgr
愋	runb
愃	riff
愂	gxkr
惼	rhce
悇	rrfa
恷	eari
恮	rrjw
恠	reuh
恛	rwlv
恖	dsri
恎	rdzx
恄	rhlv
恀	rxxx
怽	rfwx
怺	rkns
怸	akri
怷	akri
怶	rbpx
怴	rkei
怲	rfcr
怭	rrgp
怬	rwwr
怢	rgof
怟	rkxk
怓	rcbo
悈	rkso
悐	hiri
悑	rnfx
惁	adri
惞	rdxq
惒	mlri
惐	rklf
惍	rtjx
惌	ixar
惉	nulr
惈	rjau
惃	rjnn
惂	rxdi
惀	rrfc
悓	rjjx
悿	rfok
悹	ibbr
悩	rnsw
悥	briy
悤	dtri
悡	mmri
悞	rleo
悙	rake
悘	hjri
憳	rbph
憴	rgmx
憽	rswr
拀	flwr
捔	fxsy
捓	fhpf
捑	fjeo
捇	fhkk
捀	ftdf
挿	fmjr
挸	fjjs
挬	fgxk
挧	fvvx
挗	fobg
挔	fagy
挋	fhes
挊	fjjx
挄	filw
挃	fdzs
拻	feih
拹	fsss
拵	feuk
拪	fpxs
拡	fmna
拞	fdfi
捗	fpiv
捙	fdcs
捚	fvls
掋	fmkk
揊	fflv
揈	fwby
揂	fqpy
掶	fmbr
掵	fraj
掲	fjwn
掚	ffub
掔	hbfs
掓	fjib
掆	fcqu
捛	fllv
掅	fhwy
捿	fgbc
捾	fibb
捴	fknr
捳	fdfu
捪	fkxj
捦	ftjs
捤	fbmm
捠	fdfk
拁	fslv
抾	fhna
懀	rrfj
抴	fsis
戠	kjkg
戜	kljw
戙	cflk
戅	kjpr
戃	righ
戂	rmuf
懳	rddr
懱	rsuk
懪	rjsn
懩	rqog
懥	rgxp
懡	rmgn
懛	rhld
懙	rdhk
懘	nsfr
懖	tlri
懕	vjwr
懏	reck
懌	ruhg
懄	rsis
懁	rufg
戧	rkbk
戨	alak
戫	ewkf
扷	fmys
抰	fcod
抮	frcp
択	fbkd
抙	ffss
抎	fina
抌	fxwr
抁	fnwr
扻	fxqs
扸	fdps
扵	frir
戭	ifdk
扴	frka
扟	fygi
扄	hdxh
扂	hulv
戼	yhfb
戺	hosh
戵	jjek
戱	uwfk
戯	uikg
怑	rqak
怐	rwlv
怌	rgfi
嶚	uoqi
巀	uiek
嶿	ucsr
嶾	uupr
嶻	ugke
嶹	uhyh
嶵	uuuf
嶴	dqou
嶮	urqs
嶭	udkx
嶫	uiqk
嶪	uiqk
嶩	ucsm
嶨	dssu
嶧	uuhg
嶥	uvqx
嶤	uhhl
嶢	uhhl
嶡	uvqx
嶠	umll
嶟	uqph
嶞	pepu
巕	uqdc
巙	uqqt
巟	twrw
帒	ekuj
幁	uvjb
帿	uebj
帺	uuqj
帹	ukcn
帵	uixa
帴	ukkg
帬	bglu
帪	umcj
帣	qouj
帍	hujh
巤	lwsb
帇	bujj
帄	uadj
巼	olnb
巸	hose
巶	mlos
巰	flpw
巭	psof
巬	peof
巪	hbyi
嶜	uhwj
嶘	uakk
幉	usau
嶖	urvv
嵢	urkl
嵡	uknv
嵠	uuno
嵟	uveh
嵞	rfau
嵜	ukly
嵔	uvhf
嵏	uswt
嵈	uunb
嵆	mfus
嵅	ukfl
嵄	uqod
嵃	ukgc
嵀	uakj
崼	ujfp
崻	uchh
崹	uaqu
崷	uqpy
崶	uhhh
崲	udjw
崰	ulvt
嵦	uufq
嵧	ukvt
嵪	uags
嵿	uavj
嶑	uxlt
嶏	uvpo
嶌	udns
嶊	ufeh
嶉	uleh
嶆	usjj
嶅	hwtu
嶃	uddj
嶁	ulgc
嵾	unnc
嵭	uaqt
嵽	usfu
嵼	ukgp
嵻	umbn
嵹	ublq
嵸	ucrp
嵶	ubii
嵳	uqpg
嵱	uirl
嵮	ugjk
幆	ujwe
幊	upjb
怉	rwos
弽	bsau
徫	cbwc
徣	csjr
徟	cwhl
徝	cgjq
徛	coal
徚	cawq
徆	cpxc
徃	cpsc
彶	cgkd
彲	fcfc
彣	tcpe
彠	bplb
彞	bqos
彔	ensm
彑	em
彏	bjjb
彋	bufg
彉	bsdk
彇	bbdf
彅	bqwm
彂	ibji
徰	cfpp
徱	cpjs
徲	cbnp
忛	rekd
怈	rsix
忶	rina
忲	rokd
忰	rrgi
忯	rkxi
忨	rflw
忥	griq
忢	fbri
応	mrig
忓	rngx
徺	chhl
忎	mriq
忊	radx
忇	rslx
忂	cjje
忁	cjwn
忀	casg
徿	ckwu
徾	cbyc
徻	crfj
彁	ball
弴	bakz
幖	upjs
弳	bflp
庯	mnfg
庩	mrfa
庨	mhkz
庣	mwii
庢	mdzg
庡	magy
庘	mvjg
庎	mrka
庍	mdjg
庌	mhyg
庉	mxwk
庈	mrky
庅	mgna
庂	mreg
幯	ugba
幭	usuk
幬	uhyh
幧	ulla
幥	uifs
幠	ugsi
幘	uhjb
庰	mqso
庺	mkna
庻	msfr
弌	kfii
弲	blwy
弬	bheg
弫	bheg
弤	bkxk
弡	bhbo
弞	bxqg
弝	bobg
弜	bbgg
弖	bfig
廰	mlgr
庽	mvyg
廭	mmhj
廫	mwvc
廥	mrfj
廤	mdln
廜	mbhj
廗	msfu
廔	mlgc
廎	mnvj
廅	mhnu
堚	hxdc
堘	hqoh
堗	hihq
乊	gqkp
丳	llka
丱	wj
丯	cusp
丮	yaki
丩	wj
丣	lhbo
丠	qnfi
虍	uh
蒈	snnd
㞞	bcrp
㑚	eyap
麪	atjy
顴	sllj
閆	dlam
鉢	tafi
裋	xflq
蟶	qllj
糉	qswt
竈	ihgm
熒	iixi
堝	hrkt
乀	kd
乛	yi
堖	hlds
乤	jyix
亣	kljd
亝	nnni
亗	uirs
亇	xyim
亄	hxfe
亃	qxae
乽	hjyi
乼	nkjy
乺	ddyi
乷	nigy
乶	nyif
乴	fdyi
乲	ixyi
乯	gqhy
乮	kyim
乬	hbyi
乫	slyi
乪	yvti
乨	nlei
乧	igyi
乥	gqyi
閲	dqlw
駱	wtlv
塢	hdwt
墾	vght
騫	iskw
櫚	adll
隴	pkwu
鱷	vjll
劀	kgcm
賃	emjb
釗	tmdj
鈣	tjfe
飪	kmrs
獼	hbfs
紇	ogyi
邐	fcfo
銖	tpka
饌	kook
鷥	oodn
壢	hvmp
瘞	morh
硯	vjjs
紂	ohcs
賸	wqoj
鍥	tdmo
軾	dkpg
儷	efcm
鷓	msfd
銓	trjw
謡	bujf
締	oaqu
詮	brjw
諮	bixl
鵡	fkpd
纜	ohgj
瘍	mjfc
鮑	vwos
籮	guoe
貯	jiad
餒	kucn
愴	rrkl
軋	deic
漑	ndnw
蕪	sgsi
堯	hhhl
簍	glgc
鐳	tcvt
滬	nhlo
諺	bkgc
亪	tyiy
亯	ajrg
亰	ajiv
俔	ejjr
倲	eajr
倱	ejnn
倯	eakn
倠	eehr
倝	gjre
倗	ewwy
倊	eknr
倇	eixa
倁	ejlv
倀	eucr
俿	euhr
俽	edxq
俼	eanw
俻	etvt
俹	efka
俷	ewob
俴	ekkg
俲	eaks
俰	emlv
俙	eseu
俖	eglv
倳	ehlb
倵	efkp
倹	erre
偣	ekjr
傂	eduh
傁	edub
偼	eubp
偰	edmo
偯	eagy
偩	exjb
偨	epna
偧	eoxx
偦	eypw
偠	epcn
倽	erls
偞	esau
偝	eqnw
偗	eigj
偖	ehjr
偔	ellh
偐	ekgc
偅	emvl
偂	eqwm
偀	esco
俕	eiau
俒	eifl
亾	reie
俀	eucn
伬	ebkd
伩	eter
伣	ecjr
伜	ergi
伖	eebo
伔	exej
伆	ewcp
伄	ebus
仾	efem
仼	ejwr
仺	rbje
仹	edfr
仱	erky
仩	ejvr
仧	jrev
仦	eivr
仢	ewkd
仠	engr
仜	epgr
仚	ruse
仈	ekar
佄	esir
佅	efwr
佦	evsr
侜	euor
侺	eury
侸	eflq
侴	rfbm
侳	errh
侱	eljw
侤	ehhk
侢	ejck
侟	eeuk
侞	eclv
侙	ekpg
佨	ewos
侕	esrr
侎	eqmr
侌	rkyn
侇	eobg
侀	efsm
佸	elsr
佲	exlv
佱	ripi
佭	etak
鑊	tseb
駙	wehc
魨	vxwk
磽	vhhl
噚	lbph
堣	hvyt
塒	hjhh
嵨	udws
嶀	ucfh
幃	ubwj
庴	msjr
廏	mdne
楨	aujb
櫟	adna
櫪	avmp
欒	booa
氬	gfka
濰	noeh
灝	njaj
炾	ilwr
燴	irfj
玀	huoe
琡	jjib
癤	mgba
皰	bwos
嘜	latp
剴	uflm
傯	edtr
錕	tjnn
謳	bhll
謾	bjub
讎	ebeh
讒	bxlk
躕	pmhh
軛	dvaj
鈑	tdbo
鉸	taks
鋌	tmgy
鎩	tsae
傖	erkl
鐙	tbfq
鑱	txlk
饉	ksir
鰓	vvri
鱈	vcbj
鵪	oddn
鵯	dgdn
鷦	eidn
鷯	oqjd
皸	xdbp
糴	bqve
訌	bpgy
緙	osgs
鏜	tiht
鐃	thhl
鑴	tuel
霽	caqi
韉	ssmi
顳	lllj
駘	wnlv
騭	ppiw
驊	wsns
鯀	vgos
鯖	vhwy
鰈	vsau
鰒	vgjt
鰹	vhbh
鰾	vpjs
鶖	midn
鶘	jwdn
鶼	qbud
鷸	kgcd
鸛	slld
鼴	dbhc
鎝	tsrh
鋃	tkgg
銨	ticn
襤	xhgu
緹	ojfp
繯	oufg
膕	wwkf
莧	sjjo
菧	smkk
蜆	qjjc
衚	cjwi
褳	xdoc
褸	xlgc
詁	bjgy
鉦	tfpi
誚	biwy
賡	mbrj
輊	ddzc
輞	dcqt
鄆	xdpf
鄲	lljp
鄺	msdp
釧	tlcj
鉉	tana
詎	bhbo
螄	qdfu
齲	pgqc
綏	oucn
詬	bdfl
謫	baqj
鏞	tmbw
鐫	teck
飭	kgsl
饞	kxlk
騖	kgtw
鱸	vuvu
鴒	rkbd
鴕	dinb
鶇	ajdn
鶩	kgtd
僂	elgc
嬋	cllg
孿	book
嶸	uiia
懣	nsfr
撻	fhqo
澯	nuxq
瀨	nalj
璽	fkuk
蟯	qhhl
蕁	sbph
璣	jnnr
儕	eaqi
擣	fhyh
擯	fifj
牘	dhuj
膾	wrfj
蘄	slld
蟄	hqgq
韆	spoo
餞	kkkg
鯰	vrkr
奐	xcko
涇	nflp
捫	fdms
擻	flgt
稈	mjng
轆	dmlc
餑	kgxk
驥	wqnk
鰻	vjub
鶲	knvd
梔	adfo
甌	hllr
訛	benb
荿	skyi
謨	bsjo
傴	ehll
墘	hgjy
嫗	chll
屘	bmkz
峴	ujjs
愨	hfri
懨	rvjh
戔	kkgg
樅	acrp
殫	fxlg
殮	fxrq
澇	niis
瀅	niik
瀧	nkwu
獪	hrfj
簞	gllg
糝	qnnc
縉	olqj
縑	oqbk
繅	olja
艤	uqgk
鴝	wldn
飩	kxwk
鏹	tblq
曁	dnhf
賒	jrjs
躋	paqi
鉍	trgp
鋕	thri
鐐	toqi
閎	dena
饈	kqbc
鱒	vqph
垜	hgau
崢	uuby
錳	tkum
橈	ahhl
沺	nvts
獺	halj
簣	gljj
蓀	skgo
訖	bgyi
蹕	pjsa
鋅	tkxj
錙	tlvt
傄	eoqj
傆	evdi
傊	eljb
喒	ltuj
嘼	llvl
嘸	lgsi
嘵	lhhl
嘪	lujb
嘦	lkpc
嘥	lcpp
嘝	lxsg
嘋	lhkt
嘊	luvh
嘃	lmbw
嘂	llwl
嗿	lrkj
嗸	hwtl
嗭	gjln
嗧	slrc
嗠	uktl
嗕	lmhc
嗋	lssw
嗁	lduh
嗀	hflv
喿	llla
嘾	lpjz
噃	lgqv
噆	lhwj
嚉	liqh
嚪	ldxd
嚦	lvmp
嚠	lktm
嚝	lmsk
嚛	ldna
嚖	lddr
嚑	lmgh
嚌	laqi
嚋	lhyh
嚈	lvjh
噕	uglv
嚂	lhgu
噾	likj
噵	qqol
噲	lrfj
噦	lpki
噞	lrqv
噝	loos
噛	lpqw
噖	ljjy
喖	lajg
喅	ljkl
嚳	dssl
啿	luei
哠	lplv
哛	lnkm
哘	lcic
哅	lwsw
咼	rk
咠	llev
咟	lvjr
咞	lfso
咓	lrwv
咊	lmhv
咅	klvl
呭	lsiv
呬	lwwr
呥	lcht
呞	lyfl
呚	ltpv
呁	lwir
吢	rlvi
吘	lggi
吇	lkzv
吂	tlvw
哯	ljjv
哶	lsng
哸	lucn
啎	ggfl
啹	lbjg
啱	luvs
啨	lhwy
啢	lfub
啠	ddlv
啝	lmlv
啚	lgwl
啙	pnll
啔	hklv
唺	lcsk
哹	lukz
唹	ltri
唴	lqei
唲	ldwr
唨	lpjq
唟	hnln
唞	lfig
唕	ldgi
唀	lmgn
哾	lqlw
嚫	lkaj
嚻	llvl
叾	klve
坸	hwlv
垻	hjbt
垷	hjjt
垶	hkxt
垳	hcic
垬	hska
垨	hihc
垥	hrht
垙	hilw
垘	hehq
垗	hwii
垖	hddt
垑	hxxx
垎	htlv
垊	hoxi
垈	ekht
垁	hjit
垀	hgqh
坿	hehc
坾	hiad
坽	hrkb
坺	hebk
垽	ndht
垾	hjng
埁	hury
埩	hxby
堓	huvn
堒	hjnn
堏	atht
堎	hhkt
堈	hcqu
堁	hjau
埿	nbnh
埮	hiih
埪	hipg
埥	hhwy
埄	htdf
埡	hfka
埛	hckl
埖	hsen
埓	huhc
埐	hbxb
埍	hlwy
埌	hkgg
埉	horr
埅	ptht
坹	hixt
坴	hkht
囃	lare
坮	hnlv
圙	wksm
圕	wbhj
圔	whnu
圑	wnhc
圐	wutf
圎	wnjb
圅	bwqg
圁	wbyw
囼	wnlv
囻	woxi
囶	wkht
囲	wika
囜	wnaw
囙	wbow
囐	lufh
囏	sfll
囎	ljqj
囇	lfcm
囆	lsvq
囅	lljh
囄	ltwe
圚	wljj
圡	hkdt
圢	hadt
坃	hflw
坥	hjqt
坙	flht
坘	hfem
坖	flht
坕	uhtz
坓	ikht
坋	hkmd
坈	hxej
坅	hrky
坁	hkxi
圥	hwrt
圿	hrka
圽	hwcp
圼	jhtr
圶	ohtd
圵	hjvt
圴	hwkd
圱	mhtq
圫	hgxi
圦	hbut
吀	lmqv
叴	rlvj
傋	esch
冔	cilh
凮	evjr
凬	efjr
凩	eauj
凨	eina
凧	eujj
凣	uejs
凢	gejp
凞	ighi
凙	iuhg
凗	iueh
凕	ixjk
凒	iufq
凐	ipht
凎	itjr
冹	iebk
冸	iqak
冭	oird
冩	xdwi
冧	xaau
冣	xlbo
冟	xdnb
凲	eqbk
凷	hwkt
刅	mkad
剄	flpm
剤	tkim
剙	qsmk
剘	umdq
剓	mwgm
剒	sjmd
剏	qsmk
剈	lwmd
剆	kbnm
剅	flqm
刾	oqmd
刉	gymd
刱	ikmk
刯	fjfm
刣	nlmd
刡	oxmd
刟	mlmd
刞	jmdq
刕	mmmd
刔	brmd
刏	gmdq
冝	xjqm
兘	flnl
剫	msfm
儶	euel
僘	eitp
僗	eiis
僔	eqph
僓	eljj
僐	eqql
僌	edtp
僋	erkj
僈	ejub
僆	edoc
僃	esws
僀	esfu
傿	efpi
傽	ekjz
傼	esfo
傹	ekjw
傶	ekji
傱	ecrp
傦	ergr
傠	ebhc
傝	ejvv
傏	embl
僙	esdk
僛	euxq
僟	ennr
儝	eiia
儱	ekwu
儰	esug
儮	evmp
儫	eats
儨	eddj
儧	eooj
儤	ejsn
儢	euvr
儠	elwb
儚	esux
僡	edri
儙	eljo
儖	ehgu
儓	ehld
儑	ejni
儏	euxq
儎	egkd
僺	ella
僨	egsj
僢	euxa
剦	odmd
剭	bdmd
叝	hnab
匔	wqll
厃	xvhm
厁	rfaa
卾	llfa
卶	xxaj
卝	so
卛	boog
卋	gsfi
匸	hf
匷	hjje
齔	pnbc
匴	hgjs
匳	hrqf
匲	holl
匰	hllg
匭	hdrj
匩	hwjw
匨	hdhs
匧	horr
匥	hnso
匞	hpgf
匛	hxkd
厇	vgxi
厈	vngh
厏	vgub
厹	rnaj
叜	iibo
叓	glbo
叒	bbbo
叐	mboq
叅	nnnk
叀	dc
厽	nnna
厼	niva
厺	onad
厸	nnaa
厒	vjfh
厵	vdii
厴	vjwv
厯	vaai
厬	vjtl
厧	vgjk
厜	vmso
厛	vldj
厙	vdch
厗	vkxh
匘	nlds
匓	wbne
剶	etmd
匒	wsrh
勎	hkhs
勆	kbns
勂	plsl
劺	npsl
劸	hhsl
劷	qsly
劶	dfls
劰	dslb
劧	fsls
劤	dslj
劜	seil
劕	ddjm
劔	rmkd
劎	rmdq
劌	pkfm
劋	lllm
劆	mqbm
劅	uwqm
剾	hllm
剼	nnnm
剹	vvrm
勏	klsl
勑	asll
勓	nnds
勴	uvrs
匑	wqbg
匎	wodd
匌	wrhb
匇	wxxb
匃	wrei
匂	wnbb
勽	wreb
勼	wrjb
勶	cans
勱	svsl
勜	knvs
勮	utsl
勭	kvsl
勬	qoos
勫	gqvs
勪	mlcs
勩	sjsl
勨	xlts
勧	gfes
勡	pjsl
揔	fwcr
揦	falm
穧	maqi
牱	palv
牬	pgeg
牫	pkgn
牪	ppnn
牨	paej
牥	ptfn
牞	psln
牔	dnhc
牊	dmlv
牉	dqak
牄	drkl
牃	dsau
爴	wklu
爳	ugke
爫	uz
爩	iajc
爦	ihgj
爥	ibnq
爣	iigh
爡	isvq
爞	iqqq
爜	iiqb
牭	pwwr
牼	pflp
瑈	jkga
犅	pcqu
狅	hmrq
犻	hfuj
犳	hwkd
犱	hrkd
犫	ebep
犪	pqqt
犩	mcdp
犥	pmib
犤	punn
犣	plwb
犞	pmll
犝	pkvl
犜	pakt
犚	bjhp
犙	pnnc
犔	pgqm
犓	pwww
犐	pmig
犌	pbib
犈	pqoa
犆	pgjq
爙	iasg
爘	iuxk
爗	ijss
爖	ikwu
燞	exib
燛	hhih
燗	idwy
燑	ikvl
燍	iudj
燌	igsj
燆	imll
燅	hkhi
燀	illg
熼	ivsk
熻	irvv
熶	ijlb
熴	iujn
熮	ivvc
熭	ddbi
熫	imsi
熪	imxx
熩	ihlo
熧	crri
熢	itdo
熡	ilgc
燡	iuhg
燢	dssi
燣	iawm
燽	ihyh
爒	wioi
爑	isei
爏	ivmp
爋	imgs
爉	ilwb
爈	iuvr
爅	ight
爃	iiia
爁	ihgu
燺	iaau
燤	isvy
燷	iawj
燶	icsm
燵	ihqo
燳	ijmi
燱	ikjr
燯	icrb
燪	iswr
燩	idtt
燨	iqgk
狆	hlus
狇	hauq
狋	hjsq
玌	jeiw
珡	jjre
珟	jefx
珚	jwod
珗	jpwr
珕	jsss
珔	jeuk
珒	jbak
珎	jxiv
珄	jpsw
珁	jrww
玿	jmlv
玶	jnqk
玵	jsir
玴	jsiw
玬	jwat
玪	jrky
玣	jaub
玝	jggi
玜	jkna
玔	jlcw
玒	jpgw
珤	jjfw
珨	jrhw
珬	jkfi
琘	jkxj
瑅	jjfp
瑂	jbjm
琿	jxdc
琾	jvrk
琽	jhjr
琷	jqei
琧	fkjk
琠	jcsk
琜	jalw
琕	jdgi
珯	jhnb
琔	jifp
琓	jifl
琈	jukz
琄	jlwy
琂	jbyw
珿	jpzw
珼	jjbw
珸	jfbl
珴	jgfk
玏	jslw
玂	hsld
狏	hgoe
獿	hvjt
猠	hcsk
猚	hehq
猔	hijs
猒	jwhq
猑	hjnn
猏	hhwy
猌	ahql
猉	huqq
猈	hdgi
猆	uhqf
猅	hufq
猀	hnig
狾	hfdj
狵	hfcp
狫	hhnb
狪	hcfl
狦	hcfi
狣	hwii
狛	hdbq
狚	hjfi
狕	hnsl
猣	hswt
猳	hbib
猽	hxjk
獟	hhhl
獹	huvu
獶	hvwt
獱	hifj
獮	hfks
獫	hrqq
獥	hdtt
獤	hakt
獢	hmll
獡	hdwi
獜	hqxa
獁	hwmq
獛	hiqo
獙	hqut
獖	hgsj
獔	hdig
獓	hhwt
獌	hjub
獋	hqig
獊	hrkl
獇	hqen
熓	idwh
熑	iqbk
熐	ixjk
濵	nibj
瀮	ncaa
瀭	ndrm
瀪	getn
瀩	nmej
瀥	nvva
瀢	nljo
瀜	nflq
瀘	nuvu
瀗	nidr
瀔	nhfm
瀐	ngkf
瀎	nsuk
瀊	nueu
瀈	nvvd
瀇	nmsk
瀄	ngba
瀃	njjc
濽	nooj
濼	ndna
濻	nplj
濹	nght
瀯	niil
瀱	nuvm
瀳	nsmi
灉	nlle
灥	dndn
灟	nbnq
灛	ndlg
灚	ndsj
灙	nigh
灖	nmuf
灓	boon
灎	ncsu
灍	ndqx
灇	niqb
瀴	njjc
灆	nshu
灅	nvvh
灄	nlll
灁	nddn
瀿	ngeo
瀻	ngkk
瀸	nrrf
瀷	nvvk
瀶	nhgl
濷	nnsb
濲	nhfa
灧	nudo
濨	nqnr
澖	ndau
澔	ndpl
澓	ncgt
澑	nlhv
澏	nllu
澋	njai
澅	nbhf
澃	cvjn
潿	nwbw
潹	naaa
潷	ngba
潳	nbhj
潫	nqoo
潪	njlj
潩	nvsk
潨	ngui
潧	nqjj
潥	npqm
潣	ndte
潙	nugw
潗	neau
澚	ndqh
澛	nxjr
澝	nirs
濍	nswr
濧	niqh
濦	nupr
濥	nxik
濣	ngjg
濝	nuos
濜	nbfu
濚	niia
濖	nuhj
濐	njhj
濋	naap
澠	ngms
濇	nhrl
澾	nhqo
澺	nkjr
澸	nkfr
澷	njut
澵	nkad
澮	nrfj
澬	nixj
澢	nivt
灦	njnj
灨	nkjj
熎	iujf
烾	iiht
焹	icqt
焸	jjih
焷	idgi
焵	icqu
焳	iehh
焲	iaek
焬	ijwc
焪	iibg
焩	iwwy
焨	iciw
焧	iknr
焥	iixa
焛	dihm
焔	ixuj
焑	iwau
焍	iqbg
焋	dhih
焈	hoih
焂	euti
焁	lxih
焀	ikrl
焺	ijgs
焽	jwih
焾	irkr
煪	iqpy
熍	iill
熋	nwni
熉	iljb
熆	ihnu
熃	kgti
熀	ijil
煿	inhc
煾	iwor
煭	lfxi
煣	ikga
煀	ibww
煢	iixg
煘	ikfl
煗	isod
煓	iusr
煑	hjih
煍	imih
煈	iefh
煂	isgh
煁	iuei
烿	iwac
烼	itsh
灮	iwrh
烶	imgy
炨	iinb
炦	iebk
炥	ibka
炣	ialv
炢	iakd
炠	ivjh
炛	ienb
炗	sfih
炓	iigi
炑	iauh
炏	iihh
炍	idbo
炌	irka
炋	iguh
炈	iesh
炇	itph
炃	kmih
灷	isoh
灳	wihb
灲	imdh
灱	imdh
炩	irkb
炪	iwwk
炶	iulv
烞	iaub
烵	iswk
烴	iflp
烳	infh
烲	fdih
烰	iukz
烪	iqod
烥	iheh
烡	iska
烠	iewy
烚	irhh
炿	igwa
烗	ithh
烒	ikpg
烑	iwii
烐	iuoh
烎	fsih
烌	ieau
烉	xcki
烅	igum
烄	iaks
瑇	jhem
瑉	joxj
揧	almf
磖	vvvd
磏	vqbk
磍	vidl
磃	vduh
磀	vqwo
碿	vbiw
碸	vefs
碷	vdgj
碵	vujb
碯	vlds
碬	vbib
碫	vele
碤	vsco
碠	vaad
碒	vtjs
碋	vual
碊	vkkg
碈	vkxj
碄	vaau
碂	vijs
硻	hbvs
硹	vakn
磑	vufq
磘	vujf
瑌	jsod
磛	ddvs
礍	vsje
礋	vuhg
礊	dwev
礉	vdtt
礆	vrqs
礄	vmll
礃	vifs
礂	vhlv
礀	vdwy
磿	vmmv
磹	vpjz
磸	vqpo
磶	vdwi
磱	viis
磰	vqql
磮	vurc
磭	vmwy
磫	vcrp
磦	vpjs
磤	vdbe
磢	voss
硸	vuvn
硶	vury
硵	vuws
硴	vsen
砙	vrws
砏	vkmd
砎	vrka
砋	vpis
砃	vwat
矷	vkzs
矵	vmds
矲	junn
矪	juoi
矤	bjig
矡	kgjb
矏	jqit
矆	jseb
矄	jmgh
矃	jira
矁	jmir
矀	jcfe
瞺	jrfj
瞸	jssa
瞴	jgsi
瞲	jkgl
砛	vrky
砤	vgoe
砨	vhyi
硟	vgpg
硳	vhkk
硱	vwau
硨	vdcs
硧	vbsy
硦	vjso
硥	vfcp
硣	vhkz
硢	vrfa
硡	vien
硛	vtys
砪	vems
硘	vwlv
硔	vska
硓	vhnb
硉	vbak
硈	vhlv
硆	vrhs
硂	vrjw
砿	vmna
砽	vsys
礒	vqgk
礗	vifj
礛	vhgu
秲	mhhc
稩	mvwy
稨	mhce
稦	mbwh
稥	mijr
稤	maiv
稘	muqh
稖	mklv
稓	msjr
稒	mwjg
稐	mrfc
稏	mfka
稉	mfjs
稇	mwau
稄	mnkt
稁	amhg
秿	mnfh
秺	migx
秹	memr
秶	ixmh
秵	mwod
秴	mrhh
稪	mgjt
稫	mflv
稰	mypw
穙	miqo
穦	mifj
穥	mdhk
穤	mcsr
穣	makg
穡	mhrl
穞	mxjr
穝	mjlb
穛	meib
穚	mmll
穘	mhhl
稵	mqnn
穕	meau
穓	mvsk
穒	mdnh
穐	mxjd
穊	mbnw
穇	mnnc
穃	mirl
穁	msle
稺	mbkx
秳	mlsh
秮	mnlv
礝	vcsr
秡	mebk
祳	jmcs
祱	jqlw
祮	jhlv
祪	jxva
祦	jlfo
祣	jggy
祒	jmlv
祑	jgof
祌	jlus
礿	jwkd
礹	vllt
礸	vpwj
礷	vshu
礶	vsle
礲	vkwu
礰	vvmp
礯	viio
礭	vceh
礥	vhbj
礣	vsuk
礢	vqog
祴	jkso
祵	jwau
禈	jxdc
秎	mkmd
秠	mgfi
秞	mdoh
秝	mmhh
秜	mbnb
秛	mbph
秚	mqak
秙	mjgh
秓	mgbo
秐	mina
秌	imhh
禉	jqpy
秊	mmqh
秂	mreh
禷	jqhj
禶	jpwj
禭	jqto
禞	jags
禙	jqnw
禗	jvri
禓	jjfc
瞨	jiqo
瞦	jhlv
瞤	jdjw
甆	qnnr
畗	avtg
畕	vvtt
畍	vrka
畉	voft
畆	avna
畄	nvts
畃	dwkd
畂	vxkd
畁	dljo
甼	vadt
甶	gvtp
甮	wcsy
甧	ppwy
甤	tpss
甠	jpsr
甔	xvkr
甐	qxar
甎	dhrw
甊	lglr
甉	qbur
甈	qarw
畘	vcht
畞	gvxk
畡	vtht
疈	flvv
疧	mkxi
疦	mbre
疞	mfhk
疜	mjxb
疛	mhcb
疘	mpgb
疓	mgnb
疌	fbpz
疉	vvve
疅	vfvf
畣	rvth
疂	viij
疀	lvfp
畼	vjfc
畻	vqoh
畱	lhbv
畮	vgem
畭	vrfa
畩	vagy
畨	qvtm
甇	iixr
甅	rvvl
疩	mrgi
甂	hcrw
瓄	jhuj
瓁	jseb
璼	jhgu
璻	jvvg
璸	jifj
璶	jbfu
璵	jdhk
璴	jaap
璳	jpkj
璭	jxdo
璦	juxt
璤	jdri
璢	jlhv
璡	jeoc
璏	jenn
璍	jsns
璌	jifk
瑼	jdhc
瑻	jegj
瑘	jlpf
瑖	jele
瓅	jdna
瓇	jvwt
瓈	jmwn
瓩	rmqw
瓾	mcrw
瓼	rvlw
瓻	seur
瓺	urwc
瓹	lwrw
瓸	rvjr
瓳	jrwg
瓱	rmmw
瓭	xwrw
瓨	prwg
瓋	jaqo
瓥	utqq
瓡	hqgu
瓝	uwkd
瓗	juel
瓕	bfkk
瓔	jjjc
瓑	jvmp
瓎	jalj
瓍	jpeo
疨	mhyb
疭	mrre
瞣	jllr
皛	dddb
睂	rruj
眻	jqym
眳	jxlv
眲	jlem
眧	jmlv
眡	jkxk
眖	jlwr
眎	jjsm
眃	jina
盶	jflw
盵	jgyi
盰	jngm
盢	vhum
盓	nfhu
盀	uumb
皾	hujb
皷	hbpz
皶	ajfb
皳	fnkb
皨	dddh
皧	duxt
睅	jjng
睈	jljw
睉	jrrh
睻	jiff
瞛	jcrp
瞚	jifk
瞙	jsjo
瞘	jhll
瞗	jdnm
瞓	jblc
瞊	jmbl
瞈	jknv
瞁	jjhq
睷	jbag
睊	jlwy
睶	jojr
睴	jxdc
睰	jsel
睯	oxtj
睤	jvlj
睝	mwgj
睔	jrfc
睓	jcsk
睋	jgfk
皣	dsns
皔	djng
疶	msib
皒	dgfk
瘒	mxdc
瘑	mrkb
瘎	muei
瘇	mmvl
瘂	mfka
痻	mkxj
痸	mpcm
痶	mcsk
痯	mibb
痮	mucb
痭	mwwy
痬	mjwc
痥	mqlw
痝	mfcp
痜	mmej
痚	mhkz
痓	mdzb
痐	mwlv
痎	mthb
痆	mbnb
疷	mkxk
瘔	msjg
瘜	mqri
瘨	mgjk
癏	mufg
皌	dfmb
癷	bngo
癳	mvvo
癭	mjjc
癪	mmhj
癧	mvmp
癦	mght
癛	mawm
癙	mdbs
癄	meib
瘬	mbuc
瘽	msir
瘻	mlgc
瘺	mbcy
瘹	mtwk
瘷	malt
瘶	malx
瘲	mcrp
瘱	morr
瘯	mtgj
潖	njjo
潓	ndri
潒	nxlt
桼	arns
桹	akgg
桸	aseu
桵	aucn
桳	anog
桰	akxl
桬	niga
桞	axpf
桝	axak
桛	ajjx
桙	anpn
桘	addu
桒	gsau
桏	appf
桋	aobg
栺	anjr
栶	awod
栵	afxm
栰	aekg
栯	aewy
栮	aleu
栭	asru
桺	alhb
桽	arrh
潎	nqut
桾	abgl
梸	ammd
梷	ulba
梪	aflq
梥	inau
梤	aukm
梞	aori
梜	aorr
梚	axlw
梙	allu
梖	ajbu
梕	amkr
梒	arkl
梑	ahih
梎	adnb
梍	adxi
梋	alwy
梊	fdau
梉	adhs
梇	ajso
梄	apyu
梂	afnk
栬	axob
栫	aeuk
栨	aixq
栧	adgp
枩	akna
枦	ahhu
枤	ahqu
枡	agso
枖	amyu
枔	arky
枎	aofu
枍	akhk
枈	nnau
枅	afso
枂	awyu
枀	knau
杽	afsu
杺	ariu
杶	axwk
杫	apiu
杧	atwu
杣	ausu
杢	apgu
杚	agyi
杘	baus
枽	gsfa
枾	aaka
柇	amhu
柾	afpi
栦	anlc
栤	ains
栠	emau
栜	aack
栛	asss
栚	aqod
栙	atak
栍	apsu
栂	aemu
柼	aixu
柉	agoz
柶	awwr
柭	aebk
柨	aeuj
柧	augu
柡	ains
柖	amlv
柍	acod
柌	ayfl
柋	ekau
梹	adfk
梺	aajx
梻	aebk
椻	ahjc
榃	aavt
榁	aidz
楿	amjr
楾	adns
楴	aaqu
楳	asia
楲	akfc
楰	adre
楖	abna
楒	avri
楑	abfo
楐	avrk
楎	axdc
楍	alll
楋	aalm
楈	aypw
楇	arku
楆	apcn
楅	aflv
楁	aitl
楀	agqc
榋	abbb
榌	ayfu
榏	aqku
榰	ahnj
槄	audi
榿	aufq
榽	auno
榹	aduh
榸	ahvl
榶	ambl
榵	asle
榳	ammg
榲	awru
榬	ahlg
榐	absh
榪	awmu
榩	aute
榤	axaa
榣	aujf
榠	axjk
榞	avdi
榝	asae
榓	argu
榒	abii
椾	aqwm
椺	aela
梽	ahri
椷	akfl
椆	awhl
椂	abns
棿	adwr
棾	aaxe
棴	awab
棳	abbb
棯	arkr
棭	aaek
棩	addf
棦	axby
棥	assa
棤	asjr
棢	acqt
棞	awmh
棜	atri
棛	aanw
棖	aucu
棑	aufu
棏	ajfh
棎	axka
棇	aknr
椇	ajka
椉	axaa
椌	aipg
椥	ajlv
椶	aswt
椳	avhf
椱	agjt
椮	anoc
椬	aijq
椩	ambr
椨	ameh
椧	araj
椦	aqos
椣	acsk
椔	alvt
椢	awjk
椡	admd
椞	adau
検	arre
椛	asen
椚	admu
椘	aaoz
椖	ahtf
椕	akma
杔	agxi
杒	amkd
杋	aekd
擛	fssa
攗	fmqm
攕	frrf
攑	fdha
攎	fuvu
攍	ftcn
攌	fwug
攊	fvmp
攈	fmmh
攇	fidr
攄	fuvr
攃	fswj
攂	fvvv
攁	fqog
擹	fsfx
擸	flwb
擶	fgqm
擮	fgke
擨	fdux
擥	hguf
擟	ffks
擝	fjwu
攚	fiil
攛	fidb
攞	fuoe
敒	edtp
敳	uflt
敱	uflb
敮	mdub
敩	nxkt
敥	iiub
敡	jwcb
敟	cskt
敜	rkyt
敓	klwt
敐	mtpc
攠	fmuf
敋	tltp
敆	rubo
敄	kgtp
敂	wltp
攼	ntpg
攷	htpk
攳	gbbh
攭	fetq
攩	figh
擜	fgch
擙	fdqo
敹	uxgt
擏	fswt
摢	fugh
摙	fdoc
摏	fodi
摌	fkgp
摉	firx
摂	flii
搻	rffs
搸	fomh
搷	fgjk
搱	fbkx
搮	fpau
搩	fxaa
搣	fkfi
搟	fdng
搚	fssw
搑	fsle
搈	firl
搄	frff
揱	iwmf
揯	frff
揬	fihq
摣	fujq
摤	foss
摨	fbnp
撜	fbfq
擌	fgor
擈	fiqk
擆	fshj
擃	fcsm
撱	fpew
撪	fnod
撨	feib
撡	fnnk
撠	fgjk
撔	fjai
摫	fojj
撎	fhxq
撍	fhwj
撋	fdjw
撉	aktf
摼	fhbh
摷	flja
摱	fjub
摮	hwtf
摬	fkjw
敶	pajt
敾	qqlt
杊	alcu
晿	jjjr
曗	jiqk
曔	jswt
曓	jwwf
曑	jjjc
曍	jqig
曋	jpjz
曊	jbkj
曃	jbno
曂	jsdk
暺	jllg
暯	jsjo
暬	hkhj
暥	jjic
暟	jufq
暞	jqau
暜	kkjr
暚	jujf
暓	kgtj
暊	jvjb
暆	jtgo
暃	jufr
曟	jjjm
曡	jjjj
曢	jioi
朙	wkcw
杅	afhc
朻	awju
朹	arju
朷	amdu
朰	ayiu
朤	wwww
朢	hwjw
朠	wsco
朚	tjwy
朑	wsiy
曥	juvu
朇	rfjg
朆	qjqc
朄	dawq
朂	jlsl
朁	hwhj
曻	jxak
曯	jbnq
曭	jigh
曧	jflq
暀	jckj
晽	jaau
敿	mlct
晭	jwhl
旘	tkjk
旔	tbag
旍	tgrb
旈	tanw
旀	tniv
斾	tguj
斻	tgej
斺	trka
斴	qxad
斳	sidj
斱	hjdj
斦	ddjj
斞	drig
斘	xigi
斖	tdcj
斔	tqdr
斒	thce
斏	tkgg
斍	tjje
斈	tkze
斆	dsst
旞	tgqo
旟	tgdk
旤	rhwr
昣	jrcp
晪	jcsk
晥	jifl
晠	jkyi
晜	jqbg
晘	jjng
晐	jthr
晆	jhht
昿	jmna
昮	jpsl
昢	jwwk
旪	jgir
昘	jtfr
昗	jaka
昑	jrky
昍	jjrr
昋	fojr
昈	jhhr
旾	xwjr
旲	jodr
旫	jmdr
槆	aswj
槇	anjk
槈	amhc
汿	nkys
泴	nums
泲	ngeg
泭	nehc
泧	nkei
泦	nbrj
泤	nekr
泟	nfpi
泘	ngqh
泎	ngub
泍	nafi
泋	ngso
沶	njss
沵	nxiv
沰	nvss
沯	nvss
沠	nuzs
沞	nfuj
沜	ndps
沎	nenb
沋	nfos
沊	xwns
洀	nuos
洆	nynf
洉	ndfl
浢	nflq
涺	nbjg
涥	nake
涜	nhxw
涚	nqlw
涋	nihq
涆	njng
涄	ndhk
涃	nwau
浱	nmcs
浝	nfcp
洍	nhes
浘	nbmm
浗	nfnk
浌	nekg
洯	dmns
洡	ndka
洜	tlns
洘	nhhk
洖	nlfo
洕	nkwy
沀	nkys
汼	npns
淁	nkcn
汻	nggi
毸	mvri
毶	mnoc
毴	mufm
毲	bbbm
毮	figm
毭	flqm
毩	mqmm
毥	mwjr
毤	knwm
毠	slmm
毟	igmm
毞	nnmm
毝	mcpm
毊	hbel
毈	kkke
毇	dqes
毄	dles
殻	hejs
殸	hbes
殶	kjes
殩	fxuq
毺	mrfm
毻	epwm
毿	nnnm
汅	nhks
汳	ndbo
汯	nena
汬	ikns
汫	nika
汣	nxkd
汢	nhts
汖	unss
汓	nkzs
汏	nods
汄	nres
氌	mvjr
氻	nsls
氷	knsd
氱	gjfc
氭	gajr
氥	gpxq
氠	gdsq
氞	gfcr
氝	gcre
氒	kxgi
涻	nrls
淃	nqoa
殧	fxaf
溔	nqib
滵	niru
滱	nifb
滰	nkjw
滮	nucp
滧	nakt
滣	nmlv
滜	ndog
滙	nheh
滒	nall
滐	nxaa
滎	iixn
滊	ngqm
溾	ndgs
溸	nhos
溮	ndfu
溭	nvkt
溬	nqen
溩	ndws
溣	nerc
溠	nqpg
溛	niug
滻	nkgp
滽	nmbw
漀	hben
漹	nfpi
潌	nidz
潊	nrfb
潉	nujn
潈	nuts
潃	nctw
潂	nuqi
潀	nuer
漽	nbnp
漺	noss
漵	nrft
漃	nijb
漮	nmbn
漨	ntdo
漞	nujj
漜	naah
漗	ndtr
漖	nhkt
漐	hqgn
漍	nwkf
漊	nlgc
溗	nmqn
溒	nhlg
淉	njau
溑	nijb
湀	nbfo
渽	ngkl
渷	nakw
渶	nsco
渵	nsvt
渱	nqpg
渮	nsal
渪	ngqc
渢	nefs
渜	nsod
渆	nqsm
渁	nnns
淶	nals
淭	nhau
淥	nens
淣	ndwr
淢	nklf
淗	nwqm
淔	ngjq
淐	njjr
淎	noak
湁	nfrh
湂	nllh
湆	nkjr
湤	ntgo
溊	nbib
溂	nalm
湽	nlfv
湼	ndpg
湺	nela
湷	nojr
湱	ndvs
湰	ntfp
湭	nqpy
湡	nvys
湇	nkwy
湠	nuei
湞	nujb
湚	nwnw
湕	nbag
湒	nlle
湐	nadb
湏	nvjb
湌	nkss
湈	nsia
殨	fxlj
殦	fxdn
槉	amji
橓	auxa
檁	aawm
橽	ahqo
橻	abbb
橺	adjr
橷	adqw
橶	agjk
橵	aswt
橴	apno
橳	awqs
橲	ahlv
橰	aqig
橯	aiis
橮	akjb
橭	ajkx
橪	awhi
橩	aiie
橨	agsj
橤	rrra
橣	airs
橠	aaxg
橜	vqwa
檂	acsm
檃	pupa
檅	apki
檭	atgg
檽	acsr
檼	aupr
檺	aats
檹	atgl
檷	afks
檴	aseb
檲	awdh
檱	aguq
檰	aodu
檪	adia
檆	aiil
檧	aswr
檦	apjm
檤	aqqo
檙	ajdd
檕	dwea
檏	aiqk
檌	auuf
檋	askd
檈	aufg
橗	asjw
橒	acin
櫀	auos
橍	adjw
樚	amlu
樒	airu
樎	aiej
樍	ahjb
樌	aegj
樈	akjw
樄	apaj
樀	aaqj
槾	ajub
槼	ojau
槹	adig
槶	awkf
槵	allr
槬	aofu
槫	adhc
槩	bnha
槧	ddau
槣	aiol
槝	adus
槗	aell
槏	aqbk
樜	amsi
樝	aujq
樢	adnu
樼	abkk
橌	adwy
橊	alhv
橆	gsfa
橅	agsi
橃	abbe
橂	aqpo
橁	agwj
橀	aanu
樿	allg
樷	aalb
樦	agkj
樶	ajlb
樴	akjk
樲	akij
樰	acbj
樮	apih
樭	auht
樬	adtr
権	agfe
樧	asae
檾	iixa
櫁	airq
殥	fxik
欐	afcm
歏	sixq
歋	duxq
歊	axqg
歄	rxqk
欼	bbbx
欴	kbnx
欳	ucxq
欰	guxq
欮	qwxq
欭	woxq
欫	gfpx
欩	mlxq
欨	wlxq
欦	rkyx
欥	jxqr
欟	aslj
欜	aglg
欚	aetq
欙	avvo
欘	abnq
欕	allt
歓	gfex
歕	gsjx
歖	hlxq
殅	fxps
殟	fxju
殙	fxkj
殗	fxod
殕	fxkl
殔	fxbn
殐	fxal
殎	fxor
殌	fxfp
殈	fxgu
歾	fxwc
歗	bddx
歶	pnvy
歱	pmvl
歰	mkmp
歮	pppi
歬	puoi
歫	phbo
歨	ppzi
歞	jnnx
歚	qqlx
欓	aigh
欏	auoe
櫅	aaqi
欎	assh
櫦	amyt
櫤	agqm
櫣	asdo
櫢	algt
櫡	aghj
櫠	ambe
櫞	aoet
櫙	ashl
櫘	addr
櫗	asuk
櫖	auvr
櫕	aooj
櫔	avsv
櫓	avjr
櫒	aswj
櫐	vvva
櫏	apoo
櫎	amsk
櫌	avwt
櫊	adtl
櫇	abvj
櫧	abhj
櫨	auvu
櫩	adxd
櫼	arrf
欌	askh
欋	ajje
欈	auel
欇	alll
欆	aeeb
欂	asnh
欁	acsa
欀	aasg
櫾	aujo
櫹	asbf
櫭	abnf
櫸	adha
櫷	aggm
櫶	aidr
櫵	asei
櫳	akwu
櫲	akxt
櫰	aaug
櫯	avmh
櫮	ajll
𬺓	prwp
